A	A-  prefix (also an- before a vowel sound) not, without (amoral). [greek]	thout (amoral). [greek]	
Aa	abbr. 1 automobile association. 2 alcoholics anonymous. 3 anti-aircraft.	mous. 3 anti-aircraft.	
Aardvark	n. Mammal with a tubular snout and a long tongue, feeding on termites. [afrikaans]	feeding on termites. [afrikaans]	
Ab-	prefix off, away, from (abduct). [latin]		
Aback	adv.  take aback surprise, disconcert. [old english: related to *a2]	sh: related to *a2]	
Abacus	n. (pl. -cuses) 1 frame with wires along which beads are slid for calculating. 2 archit. Flat slab on top of a capital. [latin from greek from hebrew]	ds are slid for calculating. 2 archit. Flat slab on top of a capital. [latin from greek from hebrew]	
Abaft	naut. â€”adv. In the stern half of a ship. â€”prep. Nearer the stern than. [from *a2, -baft: see *aft]	. Nearer the stern than. [from *a2, -baft: see *aft]	
Abandon	â€”v. 1 give up. 2 forsake, desert. 3 (often foll. By to; often refl.) Yield to a passion, another's control, etc. â€”n. Freedom from inhibitions.  abandonment n. [french: related to *ad-, *ban]	 By to; often refl.) Yield to a passion, another's control, etc. â€”n. Freedom from inhibitions.  abandonment n. [french: related to *ad-, *ban]	
Abandoned	adj. 1 deserted, forsaken. 2 unrestrained, profligate.	ate.	
Abase	v. (-sing) (also refl.) Humiliate, degrade.  abasement n. [french: related to *ad-, *base2]	ement n. [french: related to *ad-, *base2]	
Abashed	predic. Adj. Embarrassed, disconcerted. [french es- *ex-1, baÃ¯r astound]	- *ex-1, baÃ¯r astound]	
Abate	v. (-ting) make or become less strong etc.; diminish.  abatement n. [french abatre from latin batt(u)o beat]	sh.  abatement n. [french abatre from latin batt(u)o beat]	
Abattoir	n. Slaughterhouse. [french abatre fell, as *abate]		
Abbacy	n. (pl. -ies) office or jurisdiction of an abbot or abbess. [latin: related to *abbot]	r abbess. [latin: related to *abbot]	
AbbÃ©	n. (in france) abbot or priest. [french from latin: related to *abbot]	: related to *abbot]	
Abbess	n. Head of a community of nuns.		
Abbey	n. (pl. -s) 1 building(s) occupied by a community of monks or nuns. 2 the community itself. 3 building that was once an abbey.	of monks or nuns. 2 the community itself. 3 building that was once an abbey.	
Abbot	n. Head of a community of monks. [old english from latin abbas]	 latin abbas]	
Abbreviate	v. (-ting) shorten, esp. Represent (a word etc.) By a part of it.  abbreviation n. [latin: related to *brief]	y a part of it.  abbreviation n. [latin: related to *brief]	
Abc	n. 1 the alphabet. 2 rudiments of a subject. 3 alphabetical guide.	habetical guide.	
Abdicate	v. (-ting) 1 (usu. Absol.) Give up or renounce (the throne). 2 renounce (a duty, right, etc.).  abdication n. [latin dico declare]	e throne). 2 renounce (a duty, right, etc.).  abdication n. [latin dico declare]	
Abdomen	n. 1 the belly, including the stomach, bowels, etc. 2 the hinder part of an insect etc.  abdominal adj. [latin]	. 2 the hinder part of an insect etc.  abdominal adj. [latin]	
Abduct	v. Carry off or kidnap illegally.  abduction n. Abductor n. [latin duco lead]	bductor n. [latin duco lead]	
Abeam	adv. At right angles to a ship's or an aircraft's length.	length.	
Aberdeen	angus  n. Animal of a scottish breed of hornless black cattle. [aberdeen in scotland]	lack cattle. [aberdeen in scotland]	
Aberdonian	â€”adj. Of aberdeen. â€”n. Native or citizen of aberdeen. [medieval latin]	erdeen. [medieval latin]	
Aberrant	adj. Deviating from what is normal or accepted. [latin: related to *err]	atin: related to *err]	
Aberration	n. 1 aberrant behaviour; moral or mental lapse. 2 biol. Deviation from a normal type. 3 distortion of an image because of a defect in a lens or mirror. 4 astron. Apparent displacement of a celestial body.	biol. Deviation from a normal type. 3 distortion of an image because of a defect in a lens or mirror. 4 astron. Apparent displacement of a celestial body.	
Abet	v. (-tt-) (usu. In aid and abet) encourage or assist (an offender or offence). [french: related to *ad-, *bait]	st (an offender or offence). [french: related to *ad-, *bait]	
Abeyance	n. (usu. Prec. By in, into) temporary disuse. [french: related to *ad-, beer gape]	nch: related to *ad-, beer gape]	
Abhor	v. (-rr-) detest; regard with disgust. [latin: related to *horror	ated to *horror	
Abhorrence	n. Disgust; detestation.		
Abhorrent	adj. (often foll. By to) disgusting or hateful.		
Abide	v. (-ding; past abided or rarely abode) 1 (usu. In neg.) Tolerate, endure (can't abide him). 2 (foll. By by) a act in accordance with (abide by the rules). B keep (a promise). 3 archaic remain, continue. [old english a- intensive prefix, *bide]	 neg.) Tolerate, endure (can't abide him). 2 (foll. By by) a act in accordance with (abide by the rules). B keep (a promise). 3 archaic remain, continue. [old english a- intensive prefix, *bide]	
Abiding	adj. Enduring, permanent.		
Ability	n. (pl. -ies) 1 (often foll. By to + infin.) Capacity or power. 2 cleverness, talent. [french: related to *able]	ity or power. 2 cleverness, talent. [french: related to *able]	
-ability	suffix forming nouns of quality from, or corresponding to, adjectives in -able.	ding to, adjectives in -able.	
Ab	initio  adv. From the beginning. [latin]		
Abject	adj. Miserable, wretched; degraded; despicable.  abjection n. [latin jacio -ject- throw]	abjection n. [latin jacio -ject- throw]	
Abjure	v. (-ring) renounce on oath (an opinion, cause, etc.).  abjuration n. [latin juro swear]	c.).  abjuration n. [latin juro swear]	
Ablative	gram. â€”n. Case (in latin) of nouns and pronouns indicating an agent, instrument, or location. â€”adj. Of or in the ablative. [latin ablatus taken away]	indicating an agent, instrument, or location. â€”adj. Of or in the ablative. [latin ablatus taken away]	
Ablaze	predic. Adj. & adv. 1 on fire. 2 glittering, glowing. 3 greatly excited.	ng. 3 greatly excited.	
Able	adj. (abler, ablest) 1 (often foll. By to + infin.; used esp. In is able, will be able, etc., replacing tenses of can) having the capacity or power (not able to come). 2 talented, clever.  ably adv. [latin habilis]	; used esp. In is able, will be able, etc., replacing tenses of can) having the capacity or power (not able to come). 2 talented, clever.  ably adv. [latin habilis]	
-able	suffix forming adjectives meaning: 1 that may or must be (eatable; payable). 2 that can be made the subject of (dutiable; objectionable). 3 relevant to or in accordance with (fashionable; seasonable). [latin -abilis]	ust be (eatable; payable). 2 that can be made the subject of (dutiable; objectionable). 3 relevant to or in accordance with (fashionable; seasonable). [latin -abilis]	
Able-bodied	adj. Fit, healthy.		
Able-bodied	seaman  n. Ordinary trained seaman.		
Ablution	n. (usu. In pl.) 1 ceremonial washing of the hands, sacred vessels, etc. 2 colloq. A ordinary bodily washing. B place for this. [latin ablutio from luo lut- wash]	, sacred vessels, etc. 2 colloq. A ordinary bodily washing. B place for this. [latin ablutio from luo lut- wash]	
-ably	suffix forming adverbs corresponding to adjectives in -able.	 in -able.	
Abm	abbr. Anti-ballistic missile.		
Abnegate	v. (-ting) give up or renounce (a pleasure or right etc.). [latin nego deny]	t etc.). [latin nego deny]	
Abnegation	n. Denial; renunciation of a doctrine.		
Abnormal	adj. Deviating from the norm; exceptional.  abnormality n. (pl. -ies). Abnormally adv. [french: related to *anomalous]	mality n. (pl. -ies). Abnormally adv. [french: related to *anomalous]	
Abo	(also abo) austral. Slang usu. Offens. â€”n. (pl. -s) aboriginal. â€”adj. Aboriginal. [abbreviation]	-s) aboriginal. â€”adj. Aboriginal. [abbreviation]	
Aboard	adv. & prep. On or into (a ship, aircraft, etc.). [from *a2]	[from *a2]	
Abode1	n. Dwelling-place. [related to *abide]		
Abode2	see *abide.		
Abolish	v. Put an end to (esp. A custom or institution). [latin aboleo destroy]	latin aboleo destroy]	
Abolition	n. Abolishing or being abolished.  abolitionist n.	.	
A-bomb	n. = *atomic bomb. [a for *atomic]		
Abominable	adj. 1 detestable, loathsome. 2 colloq. Very unpleasant (abominable weather).  abominably adv. [latin abominor deprecate]	asant (abominable weather).  abominably adv. [latin abominor deprecate]	
Abominable	snowman  n. Supposed manlike or bearlike himalayan animal; yeti.	 animal; yeti.	
Abominate	v. (-ting) detest, loathe.  abomination n. [latin: related to *abominable]	: related to *abominable]	
Aboriginal	â€”adj. 1 indigenous, inhabiting a land from the earliest times, esp. Before the arrival of colonists. 2 (usu. Aboriginal) of australian aborigines. â€”n. 1 aboriginal inhabitant. 2 (usu. Aboriginal) aboriginal inhabitant of australia. [latin: related to *origin]	arliest times, esp. Before the arrival of colonists. 2 (usu. Aboriginal) of australian aborigines. â€”n. 1 aboriginal inhabitant. 2 (usu. Aboriginal) aboriginal inhabitant of australia. [latin: related to *origin]	
Aborigine	n. (usu. In pl.) 1 aboriginal inhabitant. 2 (usu. Aborigine) aboriginal inhabitant of australia.	Aborigine) aboriginal inhabitant of australia.	
Usage	when referring to the people, aboriginal is preferred for the singular form and aborigines for the plural, although aboriginals is also acceptable.	red for the singular form and aborigines for the plural, although aboriginals is also acceptable.	
Abort	v. 1 miscarry. 2 a effect abortion of (a foetus). B effect abortion in (a mother). 3 end or cause (a project etc.) To end before completion. [latin orior be born]	B effect abortion in (a mother). 3 end or cause (a project etc.) To end before completion. [latin orior be born]	
Abortion	n. 1 natural or (esp.) Induced expulsion of a foetus from the womb before it is able to survive independently. 2 stunted or deformed creature or thing. 3 failed project or action.  abortionist n.	us from the womb before it is able to survive independently. 2 stunted or deformed creature or thing. 3 failed project or action.  abortionist n.	
Aboriginal	â€”adj. 1 indigenous, inhabiting a land from the earliest times, esp. Before the arrival of colonists. 2 (usu. Aboriginal) of australian aborigines. â€”n. 1 aboriginal inhabitant. 2 (usu. Aboriginal) aboriginal inhabitant of australia. [latin: related to *origin]	arliest times, esp. Before the arrival of colonists. 2 (usu. Aboriginal) of australian aborigines. â€”n. 1 aboriginal inhabitant. 2 (usu. Aboriginal) aboriginal inhabitant of australia. [latin: related to *origin]	
Aborigine	n. (usu. In pl.) 1 aboriginal inhabitant. 2 (usu. Aborigine) aboriginal inhabitant of australia.	Aborigine) aboriginal inhabitant of australia.	
Usage	when referring to the people, aboriginal is preferred for the singular form and aborigines for the plural, although aboriginals is also acceptable.	red for the singular form and aborigines for the plural, although aboriginals is also acceptable.	
Abort	v. 1 miscarry. 2 a effect abortion of (a foetus). B effect abortion in (a mother). 3 end or cause (a project etc.) To end before completion. [latin orior be born]	B effect abortion in (a mother). 3 end or cause (a project etc.) To end before completion. [latin orior be born]	
Abortion	n. 1 natural or (esp.) Induced expulsion of a foetus from the womb before it is able to survive independently. 2 stunted or deformed creature or thing. 3 failed project or action.  abortionist n.	us from the womb before it is able to survive independently. 2 stunted or deformed creature or thing. 3 failed project or action.  abortionist n.	
Abortive	adj. Fruitless, unsuccessful.		
Abound	v. 1 be plentiful. 2 (foll. By in, with) be rich; teem. [latin unda wave]	teem. [latin unda wave]	
About	â€”prep. 1 a on the subject of (a book about birds). B relating to (glad about it). C in relation to (symmetry about a plane). 2 at a time near to (about six). 3 a in, round (walked about the town; a scarf about her neck). B all round from a centre (look about you). 4 at points in (strewn about the house). 5 carried with (no money about me). 6 occupied with (about her business). â€”adv. 1 a approximately (about ten miles). B colloq. In an understatement (just about had enough). 2 nearby (a lot of flu about). 3 in every direction (look about). 4 on the move; in action (out and about). 5 in rotation or succession (turn and turn about).  be about (or all about) colloq. Have as its essential nature (life is all about having fun). Be about to be on the point of (was about to laugh). [old english]	). B relating to (glad about it). C in relation to (symmetry about a plane). 2 at a time near to (about six). 3 a in, round (walked about the town; a scarf about her neck). B all round from a centre (look about you). 4 at points in (strewn about the house). 5 carried with (no money about me). 6 occupied with (about her business). â€”adv. 1 a approximately (about ten miles). B colloq. In an understatement (just about had enough). 2 nearby (a lot of flu about). 3 in every direction (look about). 4 on the move; in action (out and about). 5 in rotation or succession (turn and turn about).  be about (or all about) colloq. Have as its essential nature (life is all about having fun). Be about to be on the point of (was about to laugh). [old english]	pied with (about her business). â€”adv. 1 a approximately (about ten miles). B colloq. In an understatement (just about had enough). 2 nearby (a lot of flu about). 3 in every direction (look about). 4 on the move; in action (out and about). 5 in rotation or succession (turn and turn about).  be about (or all about) colloq. Have as its essential nature (life is all about having fun). Be about to be on the point of (was about to laugh). [old english]
About-face	n. & int. = *about-turn, about turn.	out having fun). Be about to be on the point of (was about to laugh). [old english]	
About-turn	â€”n. 1 turn made so as to face the opposite direction. 2 change of opinion or policy etc. â€”int. (about turn) mil. Command to make an about-turn.	tion. 2 change of opinion or policy etc. â€”int. (about turn) mil. Command to make an about-turn.	
Above	â€”prep. 1 over; on the top of; higher than; over the surface of (head above water; above the din). 2 more than (above twenty people). 3 higher in rank, importance, etc., than. 4 a too great or good for (not above cheating). B beyond the reach of (above my understanding; above suspicion). â€”adv. 1 at or to a higher point; overhead (the floor above; the sky above). 2 earlier on a page or in a book (as noted above). â€”adj. Preceding (the above argument). â€”n. (prec. By the) preceding text (the above shows).  above all most of all, more than anything else. Above oneself conceited, arrogant. [old english: related to *a2]	the surface of (head above water; above the din). 2 more than (above twenty people). 3 higher in rank, importance, etc., than. 4 a too great or good for (not above cheating). B beyond the reach of (above my understanding; above suspicion). â€”adv. 1 at or to a higher point; overhead (the floor above; the sky above). 2 earlier on a page or in a book (as noted above). â€”adj. Preceding (the above argument). â€”n. (prec. By the) preceding text (the above shows).  above all most of all, more than anything else. Above oneself conceited, arrogant. [old english: related to *a2]	; the sky above). 2 earlier on a page or in a book (as noted above). â€”adj. Preceding (the above argument). â€”n. (prec. By the) preceding text (the above shows).  above all most of all, more than anything else. Above oneself conceited, arrogant. [old english: related to *a2]
Above-board	adj. & adv. Without concealment; open or openly.		
Abracadabra	â€”int. Supposedly magic word used in conjuring. â€”n. Spell or charm. [latin from greek]	€”n. Spell or charm. [latin from greek]	
Abrade	v. (-ding) scrape or wear away (skin, rock, etc.) By rubbing. [latin rado scrape]	By rubbing. [latin rado scrape]	
Abrasion	n. 1 scraping or wearing away (of skin, rock, etc.). 2 resulting damaged area.	). 2 resulting damaged area.	
Abrasive	â€”adj. 1 a tending to rub or graze. B capable of polishing by rubbing or grinding. 2 harsh or hurtful in manner. â€”n. Abrasive substance.	polishing by rubbing or grinding. 2 harsh or hurtful in manner. â€”n. Abrasive substance.	
Abreast	adv. 1 side by side and facing the same way. 2 (foll. By of) up to date.	ll. By of) up to date.	
Abridge	v. (-ging) shorten (a book, film, etc.).  abridgement n. [latin: related to *abbreviate]	ment n. [latin: related to *abbreviate]	
Abroad	adv. 1 in or to a foreign country or countries. 2 widely (scatter abroad). 3 in circulation (rumour abroad).	widely (scatter abroad). 3 in circulation (rumour abroad).	
Abrogate	v. (-ting) repeal, abolish (a law etc.).  abrogation n. [latin rogo propose a law]	ion n. [latin rogo propose a law]	
Abrupt	adj. 1 sudden, hasty (abrupt end). 2 (of manner etc.) Curt. 3 steep, precipitous.  abruptly adv. Abruptness n. [latin: related to *rupture]	c.) Curt. 3 steep, precipitous.  abruptly adv. Abruptness n. [latin: related to *rupture]	
Abscess	n. (pl. Abscesses) swelling containing pus. [latin: related to *ab-, *cede]	: related to *ab-, *cede]	
Abseil	â€”v. Descend by using a doubled rope coiled round the body and fixed at a higher point. â€”n. Descent made by abseiling. [german ab down, seil rope]	 the body and fixed at a higher point. â€”n. Descent made by abseiling. [german ab down, seil rope]	
Absence	n. 1 being away. 2 time of this. 3 (foll. By of) lack of.  absence of mind inattentiveness. [latin absentia]	ack of.  absence of mind inattentiveness. [latin absentia]	
Absent	â€”adj. 1 not present. 2 not existing; lacking. 3 inattentive. â€”v.refl. Go, or stay, away.  absently adv. (in sense 3 of adj.).	inattentive. â€”v.refl. Go, or stay, away.  absently adv. (in sense 3 of adj.).	
Absentee	n. Person not present.		
Absenteeism	n. Absenting oneself from work or school etc., esp. Frequently or illicitly.	. Frequently or illicitly.	
Absentee	landlord  n. One who lets a property while living elsewhere.	elsewhere.	
Absent-minded	adj. Forgetful or inattentive.  absent-mindedly adv. Absent-mindedness n.	dv. Absent-mindedness n.	
Absinth	n. 1 wormwood. 2 (usu. Absinthe) aniseed-flavoured liqueur based on this. [french from latin]	 liqueur based on this. [french from latin]	
Absolute	â€”adj. 1 complete, utter (absolute bliss). 2 unconditional (absolute authority). 3 despotic (absolute monarch). 4 not relative or comparative (absolute standard). 5 gram. A (of a construction) syntactically independent of the rest of the sentence, as in dinner being over, we left the table. B (of an adjective or transitive verb) without an expressed noun or object (e.g. The deaf, guns kill). 6 (of a legal decree etc.) Final. â€”n. Philos. (prec. By the) that which can exist independently of anything else. [latin: related to *absolve]	nditional (absolute authority). 3 despotic (absolute monarch). 4 not relative or comparative (absolute standard). 5 gram. A (of a construction) syntactically independent of the rest of the sentence, as in dinner being over, we left the table. B (of an adjective or transitive verb) without an expressed noun or object (e.g. The deaf, guns kill). 6 (of a legal decree etc.) Final. â€”n. Philos. (prec. By the) that which can exist independently of anything else. [latin: related to *absolve]	ed noun or object (e.g. The deaf, guns kill). 6 (of a legal decree etc.) Final. â€”n. Philos. (prec. By the) that which can exist independently of anything else. [latin: related to *absolve]
Absolutely	adv. 1 completely, utterly. 2 in an absolute sense (god exists absolutely). 3  colloq. (used in reply) quite so; yes.	 (god exists absolutely). 3  colloq. (used in reply) quite so; yes.	
Absolute	majority  n. Majority over all rivals combined.		
Absolute	pitch  n. Ability to recognize or sound any given note.	note.	
Absolute	temperature  n. One measured from absolute zero.		
Absolute	zero  n. Theoretical lowest possible temperature calculated as â€“273.15Â° c (or 0Â° k).	alculated as â€“273.15Â° c (or 0Â° k).	
Absolution	n. Formal forgiveness of sins.		
Absolutism	n. Principle or practice of absolute government.  absolutist n.	 absolutist n.	
Absolve	v. (-ving) (often foll. By from, of) set or pronounce free from blame or obligation etc. [latin: related to *solve]	nce free from blame or obligation etc. [latin: related to *solve]	
Absorb	v. 1 incorporate as part of itself or oneself. 2 take in, suck up (liquid, heat, knowledge, etc.). 3 reduce the effect or intensity of; deal easily with (an impact, sound, difficulty, etc.). 4 consume (resources etc.). 5 (often as absorbing adj.) Engross the attention of. [latin sorbeo suck in]	ake in, suck up (liquid, heat, knowledge, etc.). 3 reduce the effect or intensity of; deal easily with (an impact, sound, difficulty, etc.). 4 consume (resources etc.). 5 (often as absorbing adj.) Engross the attention of. [latin sorbeo suck in]	
Absorbent	â€”adj. Tending to absorb. â€”n. Absorbent substance or organ.	ce or organ.	
Absorption	n. 1 absorbing or being absorbed. 2 mental engrossment.  absorptive adj.	ment.  absorptive adj.	
Abstain	v. 1 (usu. Foll. By from) refrain from indulging (abstained from smoking). 2 decline to vote. [latin teneo tent- hold]	abstained from smoking). 2 decline to vote. [latin teneo tent- hold]	
Abstemious	adj. Moderate or ascetic, esp. In eating and drinking.  abstemiously adv. [latin: related to *ab-, temetum strong drink]	ing.  abstemiously adv. [latin: related to *ab-, temetum strong drink]	
Abstention	n. Abstaining, esp. From voting. [latin: related to *abstain]	o *abstain]	
Abstinence	n. Abstaining, esp. From food or alcohol.  abstinent adj. [french: related to *abstain]	ent adj. [french: related to *abstain]	
Abstract	â€”adj. 1 a of or existing in thought or theory rather than matter or practice; not concrete. B (of a word, esp. A noun) denoting a quality, condition, etc., not a concrete object. 2 (of art) achieving its effect by form and colour rather than by realism. â€”v. 1 (often foll. By from) extract, remove. 2 summarize. â€”n. 1 summary. 2 abstract work of art. 3 abstraction or abstract term. [latin: related to *tract1]	ther than matter or practice; not concrete. B (of a word, esp. A noun) denoting a quality, condition, etc., not a concrete object. 2 (of art) achieving its effect by form and colour rather than by realism. â€”v. 1 (often foll. By from) extract, remove. 2 summarize. â€”n. 1 summary. 2 abstract work of art. 3 abstraction or abstract term. [latin: related to *tract1]	f art. 3 abstraction or abstract term. [latin: related to *tract1]
Abstracted	adj. Inattentive, distracted.  abstractedly adv.		
Abstraction	n. 1 abstracting or taking away. 2 abstract or visionary idea. 3 abstract qualities (esp. In art). 4 absent-mindedness.	ionary idea. 3 abstract qualities (esp. In art). 4 absent-mindedness.	
Abstruse	adj. Hard to understand, profound. [latin abstrudo -trus- conceal]	 -trus- conceal]	
Absurd	adj. Wildly illogical or inappropriate; ridiculous.  absurdity n. (pl. -ies). Absurdly adv. [latin: related to *surd]	.  absurdity n. (pl. -ies). Absurdly adv. [latin: related to *surd]	
Abta	abbr. Association of british travel agents.		
Abundance	n. 1 plenty; more than enough; a lot. 2 wealth. [latin: related to *abound]	atin: related to *abound]	
Abundance	n. 1 plenty; more than enough; a lot. 2 wealth. [latin: related to *abound]	atin: related to *abound]	
Abundant	adj. 1 plentiful. 2 (foll. By in) rich (abundant in fruit).  abundantly adv.	n fruit).  abundantly adv.	
Abuse	â€”v. (-sing) 1 use improperly, misuse. 2 insult verbally. 3 maltreat. â€”n. 1 misuse. 2 insulting language. 3 unjust or corrupt practice. 4 maltreatment (child abuse).  abuser n. [latin: related to *use]	erbally. 3 maltreat. â€”n. 1 misuse. 2 insulting language. 3 unjust or corrupt practice. 4 maltreatment (child abuse).  abuser n. [latin: related to *use]	
Abusive	adj. Insulting, offensive.  abusively adv.		
Abut	v. (-tt-) 1 (foll. By on) (of land) border on. 2 (foll. By on, against) (of a building) touch or lean upon (another). [anglo-latin butta strip of land: related to *butt1]	foll. By on, against) (of a building) touch or lean upon (another). [anglo-latin butta strip of land: related to *butt1]	
Abutment	n. Lateral supporting structure of a bridge, arch, etc.	 etc.	
Abuzz	adv. & adj. In a state of excitement or activity.		
Abysmal	adj. 1 colloq. Extremely bad (abysmal food). 2 profound, utter (abysmal ignorance).  abysmally adv. [latin: related to *abyss]	found, utter (abysmal ignorance).  abysmally adv. [latin: related to *abyss]	
Abyss	n. 1 deep chasm. 2 immeasurable depth (abyss of despair). [latin from greek, = bottomless]	spair). [latin from greek, = bottomless]	
Ac	abbr. 1 (also ac) alternating current. 2 aircraftman.	an.	
Ac	symb. Actinium.		
A/c	abbr. Account. [account current]		
-ac	suffix forming adjectives often (or only) used as nouns (cardiac; maniac). [latin -acus, greek -akos]	nouns (cardiac; maniac). [latin -acus, greek -akos]	
Acacia	n. Tree with yellow or white flowers, esp. One yielding gum arabic. [latin from greek]	lding gum arabic. [latin from greek]	
Academia	n. The academic world; scholastic life.		
Academic	â€”adj. 1 scholarly, of learning. 2 of no practical relevance; theoretical. â€”n. Teacher or scholar in a university etc.  academically adv.	l relevance; theoretical. â€”n. Teacher or scholar in a university etc.  academically adv.	
Academician	n. Member of an academy. [french acadÃ©micien]		
Academy	n. (pl. -ies) 1 place of specialized training (military academy). 2 (usu. Academy) society or institution of distinguished scholars, artists, scientists, etc. (royal academy). 3 scot. Secondary school. [greek akademeia the place in athens where plato taught]	itary academy). 2 (usu. Academy) society or institution of distinguished scholars, artists, scientists, etc. (royal academy). 3 scot. Secondary school. [greek akademeia the place in athens where plato taught]	
Acanthus	n. (pl. -thuses) 1 herbaceous plant with spiny leaves. 2 archit. Representation of its leaf. [latin from greek]	ves. 2 archit. Representation of its leaf. [latin from greek]	
A	cappella  adj. & adv. (of choral music) unaccompanied. [italian, = in church style]	ied. [italian, = in church style]	
Acas	abbr. Advisory, conciliation, and arbitration service.	ice.	
Accede	v. (-ding) (foll. By to) 1 take office, esp. As monarch. 2 assent or agree. [latin: related to *cede]	narch. 2 assent or agree. [latin: related to *cede]	
Accelerate	v. (-ting) move or cause to move or happen more quickly.  acceleration n. [latin: related to *celerity]	ickly.  acceleration n. [latin: related to *celerity]	
Accelerator	n. 1 device for increasing speed, esp. The pedal controlling the speed of a vehicle's engine. 2 physics apparatus for imparting high speeds to charged particles.	ontrolling the speed of a vehicle's engine. 2 physics apparatus for imparting high speeds to charged particles.	
Accent	â€”n. 1 particular (esp. Local or national) mode of pronunciation. 2 distinctive feature or emphasis (accent on speed). 3 prominence given to a syllable by stress or pitch. 4 mark on a letter or word to indicate pitch, stress, or vowel quality. â€”v. 1 emphasize (a word or syllable etc.). 2 write or print accents on (words etc.). 3 accentuate. [latin cantus song]	f pronunciation. 2 distinctive feature or emphasis (accent on speed). 3 prominence given to a syllable by stress or pitch. 4 mark on a letter or word to indicate pitch, stress, or vowel quality. â€”v. 1 emphasize (a word or syllable etc.). 2 write or print accents on (words etc.). 3 accentuate. [latin cantus song]	in cantus song]
Accentuate	v. (-ting) emphasize, make prominent.  accentuation n. [medieval latin: related to *accent]	on n. [medieval latin: related to *accent]	
Accept	v. 1 (also absol.) Willingly receive (a thing offered). 2 (also absol.) Answer affirmatively (an offer etc.). 3 regard favourably; treat as welcome (felt accepted). 4 believe, receive (an opinion, explanation, etc.) As adequate or valid. 5 take as suitable (does accept cheques). 6 undertake (an office or duty). [latin capio take]	red). 2 (also absol.) Answer affirmatively (an offer etc.). 3 regard favourably; treat as welcome (felt accepted). 4 believe, receive (an opinion, explanation, etc.) As adequate or valid. 5 take as suitable (does accept cheques). 6 undertake (an office or duty). [latin capio take]	
Acceptable	adj. 1 worth accepting, welcome. 2 tolerable.  acceptability n. Acceptably adv. [french: related to *accept]	ceptability n. Acceptably adv. [french: related to *accept]	
Acceptance	n. 1 willingness to accept. 2 affirmative answer to an invitation etc. 3 approval, belief (found wide acceptance).	o an invitation etc. 3 approval, belief (found wide acceptance).	
Access	â€”n. 1 way of approach or entry (shop with rear access). 2 a right or opportunity to reach or use or visit; admittance (access to secret files, to the prisoner). B accessibility. 3 archaic outburst (an access of anger). â€”v. 1 computing gain access to (data etc.). 2 accession. [french: related to *accede]	ccess). 2 a right or opportunity to reach or use or visit; admittance (access to secret files, to the prisoner). B accessibility. 3 archaic outburst (an access of anger). â€”v. 1 computing gain access to (data etc.). 2 accession. [french: related to *accede]	
Accessible	adj. (often foll. By to) 1 reachable or obtainable; readily available. 2 easy to understand.  accessibility n.	; readily available. 2 easy to understand.  accessibility n.	
Accession	â€”n. 1 taking office, esp. As monarch. 2 thing added. â€”v. Record the addition of (a new item) to a library etc.	ded. â€”v. Record the addition of (a new item) to a library etc.	
Accessory	n. (pl. -ies) 1 additional or extra thing. 2 (usu. In pl.) Small attachment, fitting, or subsidiary item of dress (e.g. Shoes, gloves). 3 (often foll. By to) person who abets or is privy to an (esp. Illegal) act. [medieval latin: related to *accede]	 In pl.) Small attachment, fitting, or subsidiary item of dress (e.g. Shoes, gloves). 3 (often foll. By to) person who abets or is privy to an (esp. Illegal) act. [medieval latin: related to *accede]	
Access	road  n. Road giving access only to the properties along it.	 along it.	
Access	time  n. Computing time taken to retrieve data from storage.	m storage.	
Accident	n. 1 unfortunate esp. Harmful event, caused unintentionally. 2 event that is unexpected or without apparent cause.  by accident unintentionally. [latin cado fall]	ntionally. 2 event that is unexpected or without apparent cause.  by accident unintentionally. [latin cado fall]	
Accidental	â€”adj. Happening by chance or accident. â€”n. Mus. Sign indicating a note's momentary departure from the key signature.  accidentally adv.	. Sign indicating a note's momentary departure from the key signature.  accidentally adv.	
Accident-prone	adj. Clumsy.		
Acclaim	â€”v. 1 welcome or applaud enthusiastically. 2 hail as (acclaimed him king). â€”n. Applause, welcome, public praise. [latin acclamo: related to *claim]	l as (acclaimed him king). â€”n. Applause, welcome, public praise. [latin acclamo: related to *claim]	
Acclamation	n. 1 loud and eager assent. 2 (usu. In pl.) Shouting in a person's honour.	ng in a person's honour.	
Acclimatize	v. (also -ise) (-zing or -sing) adapt to a new climate or conditions.  acclimatization n. [french acclimater: related to *climate]	mate or conditions.  acclimatization n. [french acclimater: related to *climate]	
Accolade	n. 1 praise given. 2 touch made with a sword at the conferring of a knighthood. [latin collum neck]	e conferring of a knighthood. [latin collum neck]	
Accommodate	v. (-ting) 1 provide lodging or room for (flat accommodates two). 2 adapt, harmonize, reconcile (must accommodate himself to new ideas). 3 a do favour to, oblige (a person). B (foll. By with) supply (a person) with. [latin: related to *commode]	ommodates two). 2 adapt, harmonize, reconcile (must accommodate himself to new ideas). 3 a do favour to, oblige (a person). B (foll. By with) supply (a person) with. [latin: related to *commode]	
Accommodating	adj. Obliging, compliant.		
Accommodation	n. 1 lodgings. 2 adjustment, adaptation. 3 convenient arrangement; settlement, compromise.	ent arrangement; settlement, compromise.	
Accommodation	address  n. Postal address used by a person unable or unwilling to give a permanent address.	 or unwilling to give a permanent address.	
Accompaniment	n. 1 instrumental or orchestral support for a solo instrument, voice, or group. 2 accompanying thing.  accompanist n. (in sense 1).	 instrument, voice, or group. 2 accompanying thing.  accompanist n. (in sense 1).	
Accompany	v. (-ies, -ied) 1 go with; escort. 2 (usu. In passive; foll. By with, by) be done or found with; supplement. 3 mus. Partner with accompaniment. [french: related to *companion]	ive; foll. By with, by) be done or found with; supplement. 3 mus. Partner with accompaniment. [french: related to *companion]	
Accomplice	n. Partner in a crime etc. [latin: related to *complex]	plex]	
Accomplish	v. Succeed in doing; achieve, complete. [latin: related to *complete]	lated to *complete]	
Accomplished	adj. Clever, skilled.		
Accomplishment	n. 1 completion (of a task etc.). 2 acquired, esp. Social, skill. 3 thing achieved.	 Social, skill. 3 thing achieved.	
Accord	â€”v. 1 (often foll. By with) be consistent or in harmony. 2 grant (permission, a request, etc.); give (a welcome etc.). â€”n. 1 agreement, consent. 2 mus. & art etc. Harmony.  of one's own accord on one's own initiative; voluntarily. With one accord unanimously. [latin cor cord- heart]	harmony. 2 grant (permission, a request, etc.); give (a welcome etc.). â€”n. 1 agreement, consent. 2 mus. & art etc. Harmony.  of one's own accord on one's own initiative; voluntarily. With one accord unanimously. [latin cor cord- heart]	
Accordance	n.  in accordance with in conformity to.  accordant adj.	ant adj.	
According	adv. 1 (foll. By to) a as stated by (according to mary). B in proportion to (lives according to his means). 2 (foll. By as + clause) in a manner or to a degree that varies as (pays according as he is able).	mary). B in proportion to (lives according to his means). 2 (foll. By as + clause) in a manner or to a degree that varies as (pays according as he is able).	
Accordingly	adv. 1 as circumstances suggest or require (please act accordingly). 2 consequently (accordingly, he left the room).	 act accordingly). 2 consequently (accordingly, he left the room).	
Accordion	n. Musical reed instrument with concertina-like bellows, keys, and buttons.  accordionist n. [italian accordare to tune]	llows, keys, and buttons.  accordionist n. [italian accordare to tune]	
Accost	v. 1 approach and address (a person), esp. Boldly. 2 (of a prostitute) solicit. [latin costa rib]	 2 (of a prostitute) solicit. [latin costa rib]	
Accession	â€”n. 1 taking office, esp. As monarch. 2 thing added. â€”v. Record the addition of (a new item) to a library etc.	ded. â€”v. Record the addition of (a new item) to a library etc.	
Accessory	n. (pl. -ies) 1 additional or extra thing. 2 (usu. In pl.) Small attachment, fitting, or subsidiary item of dress (e.g. Shoes, gloves). 3 (often foll. By to) person who abets or is privy to an (esp. Illegal) act. [medieval latin: related to *accede]	 In pl.) Small attachment, fitting, or subsidiary item of dress (e.g. Shoes, gloves). 3 (often foll. By to) person who abets or is privy to an (esp. Illegal) act. [medieval latin: related to *accede]	
Access	road  n. Road giving access only to the properties along it.	 along it.	
Access	time  n. Computing time taken to retrieve data from storage.	m storage.	
Accident	n. 1 unfortunate esp. Harmful event, caused unintentionally. 2 event that is unexpected or without apparent cause.  by accident unintentionally. [latin cado fall]	ntionally. 2 event that is unexpected or without apparent cause.  by accident unintentionally. [latin cado fall]	
Accidental	â€”adj. Happening by chance or accident. â€”n. Mus. Sign indicating a note's momentary departure from the key signature.  accidentally adv.	. Sign indicating a note's momentary departure from the key signature.  accidentally adv.	
Accident-prone	adj. Clumsy.		
Acclaim	â€”v. 1 welcome or applaud enthusiastically. 2 hail as (acclaimed him king). â€”n. Applause, welcome, public praise. [latin acclamo: related to *claim]	l as (acclaimed him king). â€”n. Applause, welcome, public praise. [latin acclamo: related to *claim]	
Acclamation	n. 1 loud and eager assent. 2 (usu. In pl.) Shouting in a person's honour.	ng in a person's honour.	
Acclimatize	v. (also -ise) (-zing or -sing) adapt to a new climate or conditions.  acclimatization n. [french acclimater: related to *climate]	mate or conditions.  acclimatization n. [french acclimater: related to *climate]	
Accolade	n. 1 praise given. 2 touch made with a sword at the conferring of a knighthood. [latin collum neck]	e conferring of a knighthood. [latin collum neck]	
Accommodate	v. (-ting) 1 provide lodging or room for (flat accommodates two). 2 adapt, harmonize, reconcile (must accommodate himself to new ideas). 3 a do favour to, oblige (a person). B (foll. By with) supply (a person) with. [latin: related to *commode]	ommodates two). 2 adapt, harmonize, reconcile (must accommodate himself to new ideas). 3 a do favour to, oblige (a person). B (foll. By with) supply (a person) with. [latin: related to *commode]	
Accommodating	adj. Obliging, compliant.		
Accommodation	n. 1 lodgings. 2 adjustment, adaptation. 3 convenient arrangement; settlement, compromise.	ent arrangement; settlement, compromise.	
Accommodation	address  n. Postal address used by a person unable or unwilling to give a permanent address.	 or unwilling to give a permanent address.	
Accompaniment	n. 1 instrumental or orchestral support for a solo instrument, voice, or group. 2 accompanying thing.  accompanist n. (in sense 1).	 instrument, voice, or group. 2 accompanying thing.  accompanist n. (in sense 1).	
Accompany	v. (-ies, -ied) 1 go with; escort. 2 (usu. In passive; foll. By with, by) be done or found with; supplement. 3 mus. Partner with accompaniment. [french: related to *companion]	ive; foll. By with, by) be done or found with; supplement. 3 mus. Partner with accompaniment. [french: related to *companion]	
Accomplice	n. Partner in a crime etc. [latin: related to *complex]	plex]	
Accomplish	v. Succeed in doing; achieve, complete. [latin: related to *complete]	lated to *complete]	
Accomplished	adj. Clever, skilled.		
Accomplishment	n. 1 completion (of a task etc.). 2 acquired, esp. Social, skill. 3 thing achieved.	 Social, skill. 3 thing achieved.	
Accord	â€”v. 1 (often foll. By with) be consistent or in harmony. 2 grant (permission, a request, etc.); give (a welcome etc.). â€”n. 1 agreement, consent. 2 mus. & art etc. Harmony.  of one's own accord on one's own initiative; voluntarily. With one accord unanimously. [latin cor cord- heart]	harmony. 2 grant (permission, a request, etc.); give (a welcome etc.). â€”n. 1 agreement, consent. 2 mus. & art etc. Harmony.  of one's own accord on one's own initiative; voluntarily. With one accord unanimously. [latin cor cord- heart]	
Accordance	n.  in accordance with in conformity to.  accordant adj.	ant adj.	
According	adv. 1 (foll. By to) a as stated by (according to mary). B in proportion to (lives according to his means). 2 (foll. By as + clause) in a manner or to a degree that varies as (pays according as he is able).	mary). B in proportion to (lives according to his means). 2 (foll. By as + clause) in a manner or to a degree that varies as (pays according as he is able).	
Accordingly	adv. 1 as circumstances suggest or require (please act accordingly). 2 consequently (accordingly, he left the room).	 act accordingly). 2 consequently (accordingly, he left the room).	
Accordion	n. Musical reed instrument with concertina-like bellows, keys, and buttons.  accordionist n. [italian accordare to tune]	llows, keys, and buttons.  accordionist n. [italian accordare to tune]	
Accost	v. 1 approach and address (a person), esp. Boldly. 2 (of a prostitute) solicit. [latin costa rib]	 2 (of a prostitute) solicit. [latin costa rib]	
Account	â€”n. 1 narration, description (an account of his trip). 2 arrangement at a bank etc. For depositing and withdrawing money, credit, etc. (open an account). 3 record or statement of financial transactions with the balance (kept detailed accounts). â€”v. Consider as (account him wise, a fool).	trip). 2 arrangement at a bank etc. For depositing and withdrawing money, credit, etc. (open an account). 3 record or statement of financial transactions with the balance (kept detailed accounts). â€”v. Consider as (account him wise, a fool).	
Accountable	adj. 1 responsible; required to account for one's conduct. 2 explicable, understandable.  accountability n.	conduct. 2 explicable, understandable.  accountability n.	
Accountant	n. Professional keeper or verifier of accounts.  accountancy n. Accounting n.	accountancy n. Accounting n.	
Accouterments	n.pl. (brit. Accoutrements) 1 equipment, trappings. 2 soldier's equipment excluding weapons and clothes. [french]	. 2 soldier's equipment excluding weapons and clothes. [french]	
Accoutrements	n.pl. (us accouterments) 1 equipment, trappings. 2 soldier's equipment excluding weapons and clothes. [french]	 soldier's equipment excluding weapons and clothes. [french]	
Accredit	v. (-t-) 1 (foll. By to) attribute (a saying etc.) To (a person). 2 (foll. By with) credit (a person) with (a saying etc.). 3 (usu. Foll. By to or at) send (an ambassador etc.) With credentials. 4 gain influence for or make credible (an adviser, a statement, etc.). [french: related to *credit]	 To (a person). 2 (foll. By with) credit (a person) with (a saying etc.). 3 (usu. Foll. By to or at) send (an ambassador etc.) With credentials. 4 gain influence for or make credible (an adviser, a statement, etc.). [french: related to *credit]	
Accredited	adj. 1 officially recognized. 2 generally accepted.	.	
Accretion	n. 1 growth or increase by accumulation, addition, or organic enlargement. 2 the resulting whole. 3 a matter so added. B adhesion of this to the core matter. [latin cresco cret- grow]	 or organic enlargement. 2 the resulting whole. 3 a matter so added. B adhesion of this to the core matter. [latin cresco cret- grow]	
Accrue	v. (-ues, -ued, -uing) (often foll. By to) come as a natural increase or advantage, esp. Financial. [latin: related to *accretion]	 a natural increase or advantage, esp. Financial. [latin: related to *accretion]	
Accumulate	v. (-ting) 1 acquire an increasing number or quantity of; amass, collect. 2 grow numerous; increase. [latin: related to *cumulus]	ity of; amass, collect. 2 grow numerous; increase. [latin: related to *cumulus]	
Accumulation	n. 1 accumulating or being accumulated. 2 accumulated mass. 3 growth of capital by continued interest.  accumulative adj.	ted mass. 3 growth of capital by continued interest.  accumulative adj.	
Accumulator	n. 1 rechargeable electric cell. 2 bet placed on a sequence of events, with the winnings and stake from each placed on the next.	 sequence of events, with the winnings and stake from each placed on the next.	
Accuracy	n. Exactness or careful precision. [latin cura care]	e]	
Accurate	adj. Careful, precise; conforming exactly with the truth or a standard.  accurately adv.	 truth or a standard.  accurately adv.	
Accursed	adj. 1 under a curse. 2 colloq. Detestable, annoying. [old english a- intensive prefix, *curse]	ng. [old english a- intensive prefix, *curse]	
Accusation	n. Accusing or being accused. [french: related to *accuse]	*accuse]	
Accusative	gram. â€”n. Case expressing the object of an action. â€”adj. Of or in this case.	n. â€”adj. Of or in this case.	
Accusatory	adj. Of or implying accusation.		
Accuse	v. (-sing) (often foll. By of) charge with a fault or crime; blame. [latin accusare: related to *cause]	 or crime; blame. [latin accusare: related to *cause]	
Accustom	v. (foll. By to) make used to (accustomed him to hardship). [french: related to *custom]	ardship). [french: related to *custom]	
Accustomed	adj. 1 (usu. Foll. By to) used to a thing. 2 customary, usual.	mary, usual.	
Ace	â€”n. 1 playing-card etc. With a single spot and generally signifying â€˜oneâ€™. 2 a person who excels in some activity. B pilot who has shot down many enemy aircraft. 3 (in tennis) unreturnable stroke (esp. A service). â€”adj. Slang excellent.  within an ace of on the verge of. [latin as unity]	enerally signifying â€˜oneâ€™. 2 a person who excels in some activity. B pilot who has shot down many enemy aircraft. 3 (in tennis) unreturnable stroke (esp. A service). â€”adj. Slang excellent.  within an ace of on the verge of. [latin as unity]	
Acellular	adj. Having no cells; not consisting of cells.		
Aceous	suffix forming adjectives in the sense â€˜of the nature ofâ€™, esp. In the natural sciences (herbaceous). [latin -aceus]	ature ofâ€™, esp. In the natural sciences (herbaceous). [latin -aceus]	
Acerbic	adj. Harsh and sharp, esp. In speech or manner.  acerbity n. (pl. -ies). [latin acerbus sour]	acerbity n. (pl. -ies). [latin acerbus sour]	
Acetaldehyde	n. Colourless volatile liquid aldehyde. [from *acetic, *aldehyde]	tic, *aldehyde]	
Acetate	n. 1 salt or ester of acetic acid, esp. The cellulose ester. 2 fabric made from this.	ose ester. 2 fabric made from this.	
Acetic	adj. Of or like vinegar. [latin acetum vinegar]		
Acetic	acid  n. Clear liquid acid giving vinegar its characteristic taste.	acteristic taste.	
Acetone	n. Colourless volatile liquid that dissolves organic compounds, esp. Paints, varnishes, etc.	ic compounds, esp. Paints, varnishes, etc.	
Acetylene	n. Hydrocarbon gas burning with a bright flame, used esp. In welding.	ed esp. In welding.	
Ache	â€”n. 1 continuous dull pain. 2 mental distress. â€”v. (-ching) suffer from or be the source of an ache. [old english]	€”v. (-ching) suffer from or be the source of an ache. [old english]	
Achieve	v. (-ving) 1 reach or attain, esp. By effort (achieved victory; achieved notoriety). 2 accomplish (a feat or task). [french achever: related to *chief]	eved victory; achieved notoriety). 2 accomplish (a feat or task). [french achever: related to *chief]	
Achievement	n. 1 something achieved. 2 act of achieving.		
Achilles	heel  n. Person's weak or vulnerable point. [achilles, greek hero in the iliad]	les, greek hero in the iliad]	
Achilles	tendon  n. Tendon connecting the heel with the calf muscles.	f muscles.	
Achromatic	adj. Optics 1 transmitting light without separation into constituent colours (achromatic lens). 2 without colour.  achromatically adv. [french: related to *a-, *chrome]	n into constituent colours (achromatic lens). 2 without colour.  achromatically adv. [french: related to *a-, *chrome]	
Achy	adj. (-ier, -iest) full of or suffering from aches.	.	
Acid	â€”n. 1 a any of a class of substances that liberate hydrogen ions in water, are usu. Sour and corrosive, turn litmus red, and have a ph of less than 7. B any compound or atom donating protons. 2 any sour substance. 3 slang the drug lsd. â€”adj. 1 sour. 2 biting, sharp (an acid wit). 3 chem. Having the essential properties of an acid.  acidic adj. Acidify v. (-ies, -ied). Acidity n. Acidly adv. [latin aceo be sour]	te hydrogen ions in water, are usu. Sour and corrosive, turn litmus red, and have a ph of less than 7. B any compound or atom donating protons. 2 any sour substance. 3 slang the drug lsd. â€”adj. 1 sour. 2 biting, sharp (an acid wit). 3 chem. Having the essential properties of an acid.  acidic adj. Acidify v. (-ies, -ied). Acidity n. Acidly adv. [latin aceo be sour]	 Acidify v. (-ies, -ied). Acidity n. Acidly adv. [latin aceo be sour]
Acid	house  n. A type of synthesized music with a simple repetitive beat, often associated with hallucinogenic drugs.	e repetitive beat, often associated with hallucinogenic drugs.	
Acid	rain  n. Acid, esp. From industrial waste gases, falling with rain.	alling with rain.	
Acid	test  n. Severe or conclusive test.		
Acidulous	adj. Somewhat acid.		
Ack-ack	colloq. â€”adj. Anti-aircraft. â€”n. Anti-aircraft gun etc. [formerly signallers' term for aa]	 gun etc. [formerly signallers' term for aa]	
Acknowledge	v. (-ging) 1 recognize; accept the truth of (acknowledged its failure). 2 confirm the receipt of (a letter etc.). 3 a show that one has noticed (acknowledged my arrival with a grunt). B express appreciation of (a service etc.). 4 recognize the validity of, own (the acknowledged king). [from *ad-, *knowledge]	wledged its failure). 2 confirm the receipt of (a letter etc.). 3 a show that one has noticed (acknowledged my arrival with a grunt). B express appreciation of (a service etc.). 4 recognize the validity of, own (the acknowledged king). [from *ad-, *knowledge]	
Acknowledgement	n. 1 act of acknowledging. 2 a thing given or done in gratitude. B letter confirming receipt of something. 3 (usu. In pl.) Author's statement of gratitude, prefacing a book.	 in gratitude. B letter confirming receipt of something. 3 (usu. In pl.) Author's statement of gratitude, prefacing a book.	
Acme	n. Highest point (of achievement etc.). [greek]		
Acne	n. Skin condition with red pimples. [latin]		
Acolyte	n. 1 person assisting a priest. 2 assistant; beginner. [greek akolouthos follower]	ner. [greek akolouthos follower]	
Aconite	n. 1 any of various poisonous plants, esp. Monkshood. 2 drug from these. [greek akoniton]	od. 2 drug from these. [greek akoniton]	
Acorn	n. Fruit of the oak, with a smooth nut in a cuplike base. [old english]	e base. [old english]	
Acoustic	adj. 1 of sound or the sense of hearing. 2 (of a musical instrument etc.) Without electrical amplification (acoustic guitar).  acoustically adv. [greek akouo hear]	usical instrument etc.) Without electrical amplification (acoustic guitar).  acoustically adv. [greek akouo hear]	
Acoustics	n.pl. 1 properties or qualities (of a room etc.) In transmitting sound. 2 (usu. As sing.) Science of sound.	n transmitting sound. 2 (usu. As sing.) Science of sound.	
Acquaint	v. (usu. Foll. By with) make aware of or familiar with (acquaint me with the facts).  be acquainted with have personal knowledge of; know slightly. [latin: related to *ad-, *cognizance]	with (acquaint me with the facts).  be acquainted with have personal knowledge of; know slightly. [latin: related to *ad-, *cognizance]	
Acquaintance	n. 1 being acquainted. 2 person one knows slightly.  acquaintanceship n.	.  acquaintanceship n.	
Acquiesce	v. (-cing) 1 agree, esp. By default. 2 (foll. By in) accept (an arrangement etc.).  acquiescence n. Acquiescent adj. [latin: related to *ad-, *quiet]	n) accept (an arrangement etc.).  acquiescence n. Acquiescent adj. [latin: related to *ad-, *quiet]	
Acquire	v. (-ring) gain for oneself; come into possession of. [latin: related to *ad-, quaero quisit- seek]	of. [latin: related to *ad-, quaero quisit- seek]	
Acquired	immune deficiency syndrome  see *aids.		
Acquired	taste  n. 1 liking developed by experience. 2 object of this.	ct of this.	
Acquirement	n. Thing acquired, esp. A mental attainment.		
Acquisition	n. 1 thing acquired, esp. When useful. 2 acquiring or being acquired. [latin: related to *acquire]	 or being acquired. [latin: related to *acquire]	
Acquisitive	adj. Keen to acquire things.		
Acquit	v. (-tt-) 1 (often foll. By of) declare not guilty. 2 refl. A behave or perform in a specified way (acquitted herself well). B (foll. By of) discharge (a duty or responsibility).  acquittal n. [latin: related to *ad-, *quit]	. 2 refl. A behave or perform in a specified way (acquitted herself well). B (foll. By of) discharge (a duty or responsibility).  acquittal n. [latin: related to *ad-, *quit]	
Acre	n. Measure of land, 4,840 sq. Yds., 0.405 ha. [old english]	 english]	
Acreage	n. A number of acres; extent of land.		
Acrid	adj. (-er, -est) bitterly pungent.  acridity n. [latin acer keen, pungent]	latin acer keen, pungent]	
Acrimonious	adj. Bitter in manner or temper.  acrimony n.		
Acrobat	n. Entertainer performing gymnastic feats.  acrobatic adj. Acrobatically adv. [greek akrobates from akron summit, baino walk]	atic adj. Acrobatically adv. [greek akrobates from akron summit, baino walk]	
Acrobatics	n.pl. 1 acrobatic feats. 2 (as sing.) Art of performing these.	rming these.	
Acronym	n. Word formed from the initial letters of other words (e.g. Laser, nato). [greek akron end, onoma name]	ords (e.g. Laser, nato). [greek akron end, onoma name]	
Acropolis	n. Citadel of an ancient greek city. [greek akron summit, polis city]	summit, polis city]	
Across	â€”prep. 1 to or on the other side of (across the river). 2 from one side to another side of (spread across the floor). 3 at or forming an angle with (a stripe across the flag). â€”adv. 1 to or on the other side (ran across). 2 from one side to another (stretched across).  across the board applying to all. [french Ã , en, croix: related to *cross]	river). 2 from one side to another side of (spread across the floor). 3 at or forming an angle with (a stripe across the flag). â€”adv. 1 to or on the other side (ran across). 2 from one side to another (stretched across).  across the board applying to all. [french Ã , en, croix: related to *cross]	
Acrostic	n. Poem etc. In which certain letters (usu. The first and last in each line) form a word or words. [greek akron end, stikhos row]	rst and last in each line) form a word or words. [greek akron end, stikhos row]	
Acrylic	â€”adj. Of synthetic material made from acrylic acid. â€”n. Acrylic fibre or fabric. [latin acer pungent, oleo to smell]	id. â€”n. Acrylic fibre or fabric. [latin acer pungent, oleo to smell]	
Acrylic	acid  n. A pungent liquid organic acid.		
Act	â€”n. 1 something done; a deed. 2 process of doing (caught in the act). 3 item of entertainment. 4 pretence (all an act). 5 main division of a play etc. 6 a decree of a legislative body. B document attesting a legal transaction. â€”v. 1 behave (acted wisely). 2 perform an action or function; take action (act as referee; brakes failed to act; he acted quickly). 3 (also foll. By on) have an effect (alcohol acts on the brain). 4 a perform a part in a play, film, etc. B pretend. 5 a play the part of (acted othello; acts the fool). B perform (a play etc.). C portray (an incident) by actions.  act for be the (esp. Legal) representative of. Act of god natural event, e.g. An earthquake. Act up colloq. Misbehave; give trouble (car is acting up). Get one's act together slang become properly organized; prepare. Put on an act colloq. Make a pretence. [latin ago act- do]	 (caught in the act). 3 item of entertainment. 4 pretence (all an act). 5 main division of a play etc. 6 a decree of a legislative body. B document attesting a legal transaction. â€”v. 1 behave (acted wisely). 2 perform an action or function; take action (act as referee; brakes failed to act; he acted quickly). 3 (also foll. By on) have an effect (alcohol acts on the brain). 4 a perform a part in a play, film, etc. B pretend. 5 a play the part of (acted othello; acts the fool). B perform (a play etc.). C portray (an incident) by actions.  act for be the (esp. Legal) representative of. Act of god natural event, e.g. An earthquake. Act up colloq. Misbehave; give trouble (car is acting up). Get one's act together slang become properly organized; prepare. Put on an act colloq. Make a pretence. [latin ago act- do]	ed quickly). 3 (also foll. By on) have an effect (alcohol acts on the brain). 4 a perform a part in a play, film, etc. B pretend. 5 a play the part of (acted othello; acts the fool). B perform (a play etc.). C portray (an incident) by actions.  act for be the (esp. Legal) representative of. Act of god natural event, e.g. An earthquake. Act up colloq. Misbehave; give trouble (car is acting up). Get one's act together slang become properly organized; prepare. Put on an act colloq. Make a pretence. [latin ago act- do]
Acting	â€”n. Art or occupation of an actor. â€”attrib. Adj. Serving temporarily or as a substitute (acting manager).	j. Serving temporarily or as a substitute (acting manager).	
Actinism	n. Property of short-wave radiation that produces chemical changes, as in photography. [greek aktis ray]	chemical changes, as in photography. [greek aktis ray]	
Actinium	n. Chem. Radioactive metallic element found in pitchblende. [as *actinism]	chblende. [as *actinism]	
Action	n. 1 process of doing or acting (demanded action). 2 forcefulness or energy. 3 exertion of energy or influence (action of acid on metal). 4 deed, act (not aware of his actions). 5 (the action) a series of events in a story, play, etc. B slang exciting activity (missed the action). 6 battle, fighting (killed in action). 7 a mechanism of an instrument. B style of movement of an animal or human. 8 lawsuit.  out of action not working. [latin: related to *act]	 2 forcefulness or energy. 3 exertion of energy or influence (action of acid on metal). 4 deed, act (not aware of his actions). 5 (the action) a series of events in a story, play, etc. B slang exciting activity (missed the action). 6 battle, fighting (killed in action). 7 a mechanism of an instrument. B style of movement of an animal or human. 8 lawsuit.  out of action not working. [latin: related to *act]	t. B style of movement of an animal or human. 8 lawsuit.  out of action not working. [latin: related to *act]
Actionable	adj. Giving cause for legal action.		
Action-packed	adj. Full of action or excitement.		
Action	point  n. Proposal for action.		
Action	replay  n. Playback of part of a television broadcast, esp. A sporting event, often in slow motion.	ast, esp. A sporting event, often in slow motion.	
Action	stations  n.pl. Positions taken up by troops etc. Ready for battle.	Ready for battle.	
Activate	v. (-ting) 1 make active. 2 chem. Cause reaction in. 3 make radioactive.	n. 3 make radioactive.	
Active	â€”adj. 1 marked by action; energetic; diligent (an active life). 2 working, operative (active volcano). 3 not merely passive or inert; positive (active support; active ingredients). 4 radioactive. 5 gram. Designating the form of a verb whose subject performs the action (e.g. Saw in he saw a film). â€”n. Gram. Active form or voice of a verb.  actively adv. [latin: related to *act]	n active life). 2 working, operative (active volcano). 3 not merely passive or inert; positive (active support; active ingredients). 4 radioactive. 5 gram. Designating the form of a verb whose subject performs the action (e.g. Saw in he saw a film). â€”n. Gram. Active form or voice of a verb.  actively adv. [latin: related to *act]	vely adv. [latin: related to *act]
Active	service  n. Military service in wartime.		
Activism	n. Policy of vigorous action, esp. For a political cause.  activist n.	 cause.  activist n.	
Activity	n. (pl. -ies) 1 being active; busy or energetic action. 2 (often in pl.) Occupation or pursuit (outdoor activities). 3 = *radioactivity.	tion. 2 (often in pl.) Occupation or pursuit (outdoor activities). 3 = *radioactivity.	
Actor	n. Person who acts in a play, film, etc. [latin: related to *act]	elated to *act]	
Actress	n. Female actor.		
Actual	adj. (usu. Attrib.) 1 existing in fact; real. 2 current. [latin: related to *act]	rrent. [latin: related to *act]	
Actuality	n. (pl. -ies) 1 reality. 2 (in pl.) Existing conditions.	tions.	
Actually	adv. 1 as a fact, really (not actually very rich). 2 strange as it may seem (he actually refused!).	 2 strange as it may seem (he actually refused!).	
Actuary	n. (pl. -ies) statistician, esp. One calculating insurance risks and premiums.  actuarial adj. [latin actuarius bookkeeper]	nsurance risks and premiums.  actuarial adj. [latin actuarius bookkeeper]	
Actuate	v. (-ting) 1 cause (a machine etc.) To move or function. 2 cause (a person) to act. [latin]	ction. 2 cause (a person) to act. [latin]	
Acuity	n. Sharpness, acuteness. [medieval latin: related to *acute]	to *acute]	
Acumen	n. Keen insight or discernment. [latin, = *acute thing]	hing]	
Acupuncture	n. Medical treatment using needles in parts of the body.  acupuncturist n. [latin acu with needle]	 body.  acupuncturist n. [latin acu with needle]	
Acute	â€”adj. (acuter, acutest) 1 serious, severe (acute hardship). 2 (of senses etc.) Keen, penetrating. 3 shrewd. 4 (of a disease) coming quickly to a crisis. 5 (of an angle) less than 90Â°. 6 (of a sound) high, shrill. â€”n. = *acute accent.  acutely adv. [latin acutus pointed]	 hardship). 2 (of senses etc.) Keen, penetrating. 3 shrewd. 4 (of a disease) coming quickly to a crisis. 5 (of an angle) less than 90Â°. 6 (of a sound) high, shrill. â€”n. = *acute accent.  acutely adv. [latin acutus pointed]	
Acute	accent  n. Diacritical mark (Â´) placed over certain letters in french etc., esp. To show pronunciation.	in letters in french etc., esp. To show pronunciation.	
-acy	suffix forming nouns of state or quality (accuracy; piracy), or an instance of it (conspiracy; fallacy). [french -acie, latin -acia, -atia, greek -ateia]	; piracy), or an instance of it (conspiracy; fallacy). [french -acie, latin -acia, -atia, greek -ateia]	
Ad	abbr. Of the christian era. [*anno domini]		
Ad	n. Colloq. Advertisement. [abbreviation]		
Ad-	prefix (altered or assimilated before some letters) implying motion or direction to, reduction or change into, addition, adherence, increase, or intensification. [latin]	) implying motion or direction to, reduction or change into, addition, adherence, increase, or intensification. [latin]	
Adage	n. Traditional maxim, proverb. [french from latin]		
Adagio	mus. â€”adv. & adj. In slow time. â€”n. (pl. -s) such a movement or passage. [italian]	uch a movement or passage. [italian]	
Adam	n. The first man.  not know a person from adam be unable to recognize a person. [hebrew, = man]	 unable to recognize a person. [hebrew, = man]	
Adamant	adj. Stubbornly resolute; unyielding.  adamantly adv. [greek adamas adamant- untameable]	adv. [greek adamas adamant- untameable]	
Adam's	apple  n. Projection of cartilage at the front of the neck.	the neck.	
Adapt	v. 1 a (foll. By to) fit, adjust (one thing to another). B (foll. By to, for) make suitable for a purpose. C modify (esp. A text for broadcasting etc.). 2 (also refl., usu. Foll. By to) adjust to new conditions.  adaptable adj. Adaptation n. [latin: related to *ad-, *apt]	ther). B (foll. By to, for) make suitable for a purpose. C modify (esp. A text for broadcasting etc.). 2 (also refl., usu. Foll. By to) adjust to new conditions.  adaptable adj. Adaptation n. [latin: related to *ad-, *apt]	
Adaptor	n. 1 device for making equipment compatible. 2 device for connecting several electrical plugs to one socket.	ice for connecting several electrical plugs to one socket.	
Add	v. 1 join (one thing to another) as an increase or supplement. 2 put together (numbers) to find their total. 3 say further.  add in include. Add up 1 find the total of. 2 (foll. By to) amount to. 3 colloq. Make sense. [latin addo]	 supplement. 2 put together (numbers) to find their total. 3 say further.  add in include. Add up 1 find the total of. 2 (foll. By to) amount to. 3 colloq. Make sense. [latin addo]	
Addendum	n. (pl. -da) 1 thing to be added. 2 material added at the end of a book.	 at the end of a book.	
Adder	n. Small venomous snake, esp. The common viper. [old english, originally nadder]	ld english, originally nadder]	
Addict	n. 1 person addicted, esp. To a drug. 2 colloq. Devotee (film addict). [latin: related to *ad-, dico say]	votee (film addict). [latin: related to *ad-, dico say]	
Addicted	adj. 1 (usu. Foll. By to) dependent on a drug etc. As a habit. 2 devoted to an interest.  addiction n.	 As a habit. 2 devoted to an interest.  addiction n.	
Addictive	adj. Causing addiction.		
Addition	n. 1 adding. 2 person or thing added.  in addition (often foll. By to) also, as well (as). [latin: related to *add]	n (often foll. By to) also, as well (as). [latin: related to *add]	
Additional	adj. Added, extra, supplementary.  additionally adv.	dv.	
Additive	n. Substance added to improve another, esp. To colour, flavour, or preserve food. [latin: related to *add]	our, flavour, or preserve food. [latin: related to *add]	
Addle	v. (-ling) 1 muddle, confuse. 2 (usu. As addled adj.) (of an egg) become rotten. [old english, = filth]	j.) (of an egg) become rotten. [old english, = filth]	
Address	â€”n. 1 a place where a person lives or an organization is situated. B particulars of this, esp. For postal purposes. C computing location of an item of stored information. 2 discourse to an audience. â€”v. 1 write postal directions on (an envelope etc.). 2 direct (remarks etc.). 3 speak or write to, esp. Formally. 4 direct one's attention to. 5 golf take aim at (the ball).  address oneself to 1 speak or write to. 2 attend to. [french: related to *ad-, *direct]	ation is situated. B particulars of this, esp. For postal purposes. C computing location of an item of stored information. 2 discourse to an audience. â€”v. 1 write postal directions on (an envelope etc.). 2 direct (remarks etc.). 3 speak or write to, esp. Formally. 4 direct one's attention to. 5 golf take aim at (the ball).  address oneself to 1 speak or write to. 2 attend to. [french: related to *ad-, *direct]	lf take aim at (the ball).  address oneself to 1 speak or write to. 2 attend to. [french: related to *ad-, *direct]
Addressee	n. Person to whom a letter etc. Is addressed.		
Adduce	v. (-cing) cite as an instance or as proof or evidence.  adducible adj. [latin: related to *ad-, duco lead]	ence.  adducible adj. [latin: related to *ad-, duco lead]	
Adenoids	n.pl. Area of enlarged lymphatic tissue between the nose and the throat, often hindering breathing in the young.  adenoidal adj. [greek aden gland]	e nose and the throat, often hindering breathing in the young.  adenoidal adj. [greek aden gland]	
Adept	â€”adj. (foll. By at, in) skilful. â€”n. Adept person. [latin adipiscor adept- attain]	son. [latin adipiscor adept- attain]	
Adequate	adj. Sufficient, satisfactory.  adequacy n. Adequately adv. [latin: related to *ad-, *equate]	ately adv. [latin: related to *ad-, *equate]	
Ã€	deux  adv. & adj. For or between two. [french]		
Adhere	v. (-ring) 1 (usu. Foll. By to) stick fast to a substance etc. 2 (foll. By to) behave according to (a rule, undertaking, etc.). 3 (foll. By to) give allegiance. [latin haereo stick]	bstance etc. 2 (foll. By to) behave according to (a rule, undertaking, etc.). 3 (foll. By to) give allegiance. [latin haereo stick]	
Adherent	â€”n. Supporter. â€”adj. Sticking, adhering.  adherence n.	erence n.	
Adhesion	n. 1 adhering. 2 unnatural union of body tissues due to inflammation.	ue to inflammation.	
Adhesive	â€”adj. Sticky, causing adhesion. â€”n. Adhesive substance.  adhesiveness n.	ubstance.  adhesiveness n.	
Ad	hoc  adv. & adj. For one particular occasion or use. [latin]	e. [latin]	
Adieu	int. Goodbye. [french, = to god]		
Ad	infinitum  adv. Without limit; for ever. [latin]		
Adipose	adj. Of fat; fatty (adipose tissue).  adiposity n. [latin adeps fat]	. [latin adeps fat]	
Adjacent	adj. (often foll. By to) lying near; adjoining.  adjacency n. [latin jaceo lie]	adjacency n. [latin jaceo lie]	
Adjective	n. Word used to describe or modify a noun or pronoun.  adjectival adj. [latin jaceo lie]	un.  adjectival adj. [latin jaceo lie]	
Adjoin	v. Be next to and joined with. [latin jungo join]		
Adjourn	v. 1 put off, postpone; break off (a meeting etc.) Temporarily. 2 (of a meeting) break and disperse or (foll. By to) transfer to another place (adjourned to the pub).  adjournment n. [latin: related to *ad-, diurnum day]	 Temporarily. 2 (of a meeting) break and disperse or (foll. By to) transfer to another place (adjourned to the pub).  adjournment n. [latin: related to *ad-, diurnum day]	
Adjudge	v. (-ging) 1 pronounce judgement on (a matter). 2 pronounce or award judicially.  adjudgement n. (also adjudgment). [latin judex judge]	pronounce or award judicially.  adjudgement n. (also adjudgment). [latin judex judge]	
Adjudicate	v. (-ting) 1 act as judge in a competition, court, etc. 2 adjudge.  adjudication n. Adjudicative adj. Adjudicator n.	 etc. 2 adjudge.  adjudication n. Adjudicative adj. Adjudicator n.	
Adjunct	n. 1 (foll. By to, of) subordinate or incidental thing. 2 gram. Word or phrase used to explain or amplify the predicate, subject, etc. [latin: related to *adjoin]	hing. 2 gram. Word or phrase used to explain or amplify the predicate, subject, etc. [latin: related to *adjoin]	
Adjure	v. (-ring) (usu. Foll. By to + infin.) Beg or command.  adjuration n. [latin adjuro put to oath: related to *jury]	and.  adjuration n. [latin adjuro put to oath: related to *jury]	
Adjust	v. 1 order or position; regulate; arrange. 2 (usu. Foll. By to) become or make suited; adapt. 3 harmonize (discrepancies). 4 assess (loss or damages).  adjustable adj. Adjustment n. [latin juxta near]	 Foll. By to) become or make suited; adapt. 3 harmonize (discrepancies). 4 assess (loss or damages).  adjustable adj. Adjustment n. [latin juxta near]	
Adjutant	n. 1 a army officer assisting a superior in administrative duties. B assistant. 2 (in full adjutant bird) giant indian stork. [latin: related to *ad-, juvo jut- help]	strative duties. B assistant. 2 (in full adjutant bird) giant indian stork. [latin: related to *ad-, juvo jut- help]	
Ad	lib  â€”v. (-bb-) improvise. â€”adj. Improvised. â€”adv. As one pleases, to any desired extent. [abbreviation of latin ad libitum according to pleasure]	€”adv. As one pleases, to any desired extent. [abbreviation of latin ad libitum according to pleasure]	
Admin	n. Colloq. Administration. [abbreviation]		
Administer	v. 1 manage (business affairs etc.). 2 a deliver or dispense, esp. Formally (a punishment, sacrament, etc.). B (usu. Foll. By to) direct the taking of (an oath). [latin: related to *ad-, *minister]	r dispense, esp. Formally (a punishment, sacrament, etc.). B (usu. Foll. By to) direct the taking of (an oath). [latin: related to *ad-, *minister]	
Administrate	v. (-ting) administer (esp. Business affairs); act as an administrator.	 as an administrator.	
Administration	n. 1 administering, esp. Public affairs. 2 government in power.	ent in power.	
Administrative	adj. Of the management of affairs.		
Administrator	n. Manager of a business, public affairs, or a person's estate.	son's estate.	
Admirable	adj. Deserving admiration; excellent.  admirably adv. [latin: related to *admire]	adv. [latin: related to *admire]	
Admiral	n. 1 a commander-in-chief of a navy. B high-ranking naval officer, commander. 2 any of various butterflies. [arabic: related to *amir]	g naval officer, commander. 2 any of various butterflies. [arabic: related to *amir]	
Admiralty	n. (pl. -ies) (in full admiralty board) hist. Committee superintending the royal navy.	ittee superintending the royal navy.	
Admiration	n. 1 respect; warm approval or pleasure. 2 object of this.	of this.	
Admire	v. (-ring) 1 regard with approval, respect, or satisfaction. 2 express admiration of.  admirer n. Admiring adj. Admirlingly adv. [latin: related to *ad-, miror wonder at]	isfaction. 2 express admiration of.  admirer n. Admiring adj. Admirlingly adv. [latin: related to *ad-, miror wonder at]	
Admissible	adj. 1 (of an idea etc.) Worth accepting or considering. 2 law allowable as evidence. [latin: related to *admit]	ering. 2 law allowable as evidence. [latin: related to *admit]	
Admission	n. 1 acknowledgement (admission of error). 2 a process or right of entering. B charge for this (admission is Â£5).	cess or right of entering. B charge for this (admission is Â£5).	
Admit	v. (-tt-) 1 (often foll. By to be, or that + clause) acknowledge; recognize as true. 2 (foll. By to) confess to (a deed, fault, etc.). 3 allow (a person) entrance, access, etc. 4 take (a patient) into hospital. 5 (of an enclosed space) accommodate. 6 (foll. By of) allow as possible. [latin mitto miss- send]	e) acknowledge; recognize as true. 2 (foll. By to) confess to (a deed, fault, etc.). 3 allow (a person) entrance, access, etc. 4 take (a patient) into hospital. 5 (of an enclosed space) accommodate. 6 (foll. By of) allow as possible. [latin mitto miss- send]	
Admittance	n. Admitting or being admitted, usu. To a place.		
Admittedly	adv. As must be admitted.		
Admixture	n. 1 thing added, esp. A minor ingredient. 2 adding of this.	g of this.	
Admonish	v. 1 reprove. 2 urge, advise. 3 (foll. By of) warn.  admonishment n. Admonition n. Admonitory adj. [latin moneo warn]	.  admonishment n. Admonition n. Admonitory adj. [latin moneo warn]	
Ad	nauseam  adv. Excessively; disgustingly. [latin, = to sickness]	 to sickness]	
Ado	n. Fuss, busy activity; trouble. [from *at, *do1: originally in much ado = much to do]	originally in much ado = much to do]	
Adobe	n. 1 sun-dried brick. 2 clay for making these. [spanish]	anish]	
Adolescent	â€”adj. Between childhood and adulthood. â€”n. Adolescent person.  adolescence n. [latin adolesco grow up]	lescent person.  adolescence n. [latin adolesco grow up]	
Adonis	n. Handsome young man. [latin, name of a youth loved by venus]	ed by venus]	
Adopt	v. 1 legally take (a person) into a relationship, esp. Another's child as one's own. 2 choose (a course of action etc.). 3 take over (another's idea etc.). 4 choose as a candidate for office. 5 accept responsibility for the maintenance of (a road etc.). 6 accept or approve (a report, accounts, etc.).  adoption n. [latin: related to *ad-, *opt]	esp. Another's child as one's own. 2 choose (a course of action etc.). 3 take over (another's idea etc.). 4 choose as a candidate for office. 5 accept responsibility for the maintenance of (a road etc.). 6 accept or approve (a report, accounts, etc.).  adoption n. [latin: related to *ad-, *opt]	
Adoptive	adj. Because of adoption (adoptive son). [latin: related to *adopt]	elated to *adopt]	
Adorable	adj. 1 deserving adoration. 2 colloq. Delightful, charming.	charming.	
Adore	v. (-ring) 1 love intensely. 2 worship as divine. 3 colloq. Like very much.  adoration n. Adorer n. [latin adoro worship]	3 colloq. Like very much.  adoration n. Adorer n. [latin adoro worship]	
Adorn	v. Add beauty to; decorate.  adornment n. [latin: related to *ad-, orno decorate]	 related to *ad-, orno decorate]	
Adrenal	â€”adj. 1 at or near the kidneys. 2 of the adrenal glands. â€”n. (in full adrenal gland) either of two ductless glands above the kidneys, secreting adrenalin. [from *ad-, *renal]	 glands. â€”n. (in full adrenal gland) either of two ductless glands above the kidneys, secreting adrenalin. [from *ad-, *renal]	
Adrenalin	n. (also adrenaline) 1 stimulative hormone secreted by the adrenal glands. 2 this extracted or synthesized for medicinal use.	d by the adrenal glands. 2 this extracted or synthesized for medicinal use.	
Adrift	adv. & predic.adj. 1 drifting. 2 powerless; aimless. 3 colloq. A unfastened. B out of order, wrong (plans went adrift).	s. 3 colloq. A unfastened. B out of order, wrong (plans went adrift).	
Adroit	adj. Dexterous, skilful. [french Ã  droit according to right]	g to right]	
Adsorb	v. (usu. Of a solid) hold (molecules of a gas or liquid etc.) To its surface, forming a thin film.  adsorbent adj. & n. Adsorption n. [from *ad-, *absorb]	iquid etc.) To its surface, forming a thin film.  adsorbent adj. & n. Adsorption n. [from *ad-, *absorb]	
Adulation	n. Obsequious flattery. [latin adulor fawn on]		
Adult	â€”adj. 1 mature, grown-up. 2 (attrib.) Of or for adults (adult education). â€”n. Adult person.  adulthood n. [latin adolesco adultus grow up]	adults (adult education). â€”n. Adult person.  adulthood n. [latin adolesco adultus grow up]	
Adulterate	v. (-ting) debase (esp. Foods) by adding other substances.  adulterant adj. & n. Adulteration n. [latin adultero corrupt]	stances.  adulterant adj. & n. Adulteration n. [latin adultero corrupt]	
Adulterer	n. (fem. Adulteress) person who commits adultery.		
Adultery	n. Voluntary sexual intercourse between a married person and a person other than his or her spouse.  adulterous adj.	person and a person other than his or her spouse.  adulterous adj.	
Adumbrate	v. (-ting) 1 indicate faintly or in outline. 2 foreshadow. 3 overshadow.  adumbration n. [latin: related to *ad-, umbra shade]	eshadow. 3 overshadow.  adumbration n. [latin: related to *ad-, umbra shade]	
Advance	â€”v. (-cing) 1 move or put forward; progress. 2 pay or lend (money) beforehand. 3 promote (a person, cause, etc.). 4 present (a suggestion etc.). 5 (as advanced adj.) A well ahead. B socially progressive. â€”n. 1 going forward; progress. 2 prepayment; loan. 3 (in pl.) Amorous approaches. 4 rise in price. â€”attrib. Adj. Done or supplied beforehand (advance warning).  advance on approach threateningly. In advance ahead in place or time. [latin: related to *ab-, ante before]	ay or lend (money) beforehand. 3 promote (a person, cause, etc.). 4 present (a suggestion etc.). 5 (as advanced adj.) A well ahead. B socially progressive. â€”n. 1 going forward; progress. 2 prepayment; loan. 3 (in pl.) Amorous approaches. 4 rise in price. â€”attrib. Adj. Done or supplied beforehand (advance warning).  advance on approach threateningly. In advance ahead in place or time. [latin: related to *ab-, ante before]	 (advance warning).  advance on approach threateningly. In advance ahead in place or time. [latin: related to *ab-, ante before]
Advanced	level  n. High level of gce examination.		
Advancement	n. Promotion of a person, cause, or plan.		
Advantage	â€”n. 1 beneficial feature. 2 benefit, profit. 3 (often foll. By over) superiority. 4 (in tennis) the next point after deuce. â€”v. (-ging) benefit, favour.  take advantage of 1 make good use of. 2 exploit, esp. Unfairly. 3 euphem. Seduce.  advantageous adj. [french: related to *advance]	often foll. By over) superiority. 4 (in tennis) the next point after deuce. â€”v. (-ging) benefit, favour.  take advantage of 1 make good use of. 2 exploit, esp. Unfairly. 3 euphem. Seduce.  advantageous adj. [french: related to *advance]	
Advent	n. 1 season before christmas. 2 coming of christ. 3 (advent) important arrival. [latin adventus from venio come]	3 (advent) important arrival. [latin adventus from venio come]	
Adventist	n. Member of a christian sect believing in the imminent second coming of christ.	inent second coming of christ.	
Adventitious	adj. 1 accidental, casual. 2 added from outside. 3 biol. Formed accidentally or under unusual conditions. [latin: related to *advent]	 biol. Formed accidentally or under unusual conditions. [latin: related to *advent]	
Adventure	â€”n. 1 unusual and exciting experience. 2 enterprise (spirit of adventure). â€”v. (-ring) dare, venture; engage in adventure. [latin: related to *advent]	ise (spirit of adventure). â€”v. (-ring) dare, venture; engage in adventure. [latin: related to *advent]	
Adventure	playground  n. Playground with climbing-frames, building blocks, etc.	ilding blocks, etc.	
Adventurer	n. (fem. Adventuress) 1 person who seeks adventure, esp. For personal gain or enjoyment. 2 financial speculator.	, esp. For personal gain or enjoyment. 2 financial speculator.	
Adventurous	adj. Venturesome, enterprising.		
Adverb	n. Word indicating manner, degree, circumstance, etc., used to modify an adjective, verb, or other adverb (e.g. Gently, quite, then).  adverbial adj. [latin: related to *ad-, verbum word, *verb]	tc., used to modify an adjective, verb, or other adverb (e.g. Gently, quite, then).  adverbial adj. [latin: related to *ad-, verbum word, *verb]	
Adversary	n. (pl. -ies) enemy, opponent.		
Adverse	adj. Unfavourable; harmful.  adversely adv. [latin: related to *ad-, verto vers- turn]	n: related to *ad-, verto vers- turn]	
Adversity	n. Misfortune, distress.		
Advert	n. Colloq. Advertisement. [abbreviation]		
Advertise	v. (-sing) 1 promote (goods or services) publicly to increase sales. 2 make generally known. 3 (often foll. By for) seek by a notice in a newspaper etc. To buy, employ, sell, etc. [french avertir: related to *adverse]	to increase sales. 2 make generally known. 3 (often foll. By for) seek by a notice in a newspaper etc. To buy, employ, sell, etc. [french avertir: related to *adverse]	
Advertisement	n. 1 public announcement, esp. Of goods etc. For sale or wanted, vacancies, etc. 2 advertising. [french avertissement: related to *adverse]	ale or wanted, vacancies, etc. 2 advertising. [french avertissement: related to *adverse]	
Advice	n. 1 recommendation on how to act. 2 information given; news. 3 formal notice of a transaction.	iven; news. 3 formal notice of a transaction.	
Advisable	adj. To be recommended, expedient.  advisability n.	n.	
Advise	v. (-sing) 1 (also absol.) Give advice to. 2 recommend (advised me to rest). 3 (usu. Foll. By of, or that + clause) inform. [latin: related to *ad-, video vis- see]	mend (advised me to rest). 3 (usu. Foll. By of, or that + clause) inform. [latin: related to *ad-, video vis- see]	
Advisedly	adv. After due consideration; deliberately.		
Adviser	n. (also advisor) person who advises, esp. Officially.	lly.	
Usage	the variant advisor is fairly common, but is considered incorrect by many people.	dered incorrect by many people.	
Advisory	adj. Giving advice (advisory body).		
Advocaat	n. Liqueur of eggs, sugar, and brandy. [dutch, = *advocate]	advocate]	
Advocacy	n. Support or argument for a cause, policy, etc.		
Advocate	â€”n. 1 (foll. By of) person who supports or speaks in favour. 2 person who pleads for another, esp. In a lawcourt. â€”v. (-ting) recommend by argument. [latin: related to *ad-, voco call]	s in favour. 2 person who pleads for another, esp. In a lawcourt. â€”v. (-ting) recommend by argument. [latin: related to *ad-, voco call]	
Adz	n. (brit adze) tool like an axe, with an arched blade at right angles to the handle. [old english]	ade at right angles to the handle. [old english]	
Adze	n. (us adz) tool like an axe, with an arched blade at right angles to the handle. [old english]	 at right angles to the handle. [old english]	
Aegis	n. Protection; support. [greek aigis shield of zeus or athene]	s or athene]	
Aeolian	harp  n. Stringed instrument or toy sounding when the wind passes through it. [latin aeolus wind-god, from greek]	the wind passes through it. [latin aeolus wind-god, from greek]	
Aeon	n. (also eon) 1 long or indefinite period. 2 an age. [latin from greek]	e. [latin from greek]	
Aerate	v. (-ting) 1 charge (a liquid) with carbon dioxide. 2 expose to air.  aeration n. [latin aer *air]	. 2 expose to air.  aeration n. [latin aer *air]	
Aerial	â€”n. Device for transmitting or receiving radio waves. â€”adj. 1 by or from the air; involving aircraft (aerial attack). 2 existing in the air. 3 of or like air. [greek: related to *air]	aves. â€”adj. 1 by or from the air; involving aircraft (aerial attack). 2 existing in the air. 3 of or like air. [greek: related to *air]	
Aero-	comb. Form air; aircraft. [greek aero- from aer air]	r]	
Aerobatics	n.pl. 1 spectacular flying of aircraft, esp. To entertain. 2 (as sing.) Performance of these. [from *aero-, after *acrobatics]	tertain. 2 (as sing.) Performance of these. [from *aero-, after *acrobatics]	
Aerobics	n.pl. Vigorous exercises designed to increase oxygen intake.  aerobic adj. [from *aero-, greek bios life]	en intake.  aerobic adj. [from *aero-, greek bios life]	
Aerodrome	n. Small airport or airfield. [from *aero-, greek dromos course]	dromos course]	
Aerodynamics	n.pl. (usu. Treated as sing.) Dynamics of solid bodies moving through air.  aerodynamic adj.	dies moving through air.  aerodynamic adj.	
Aerofoil	n. Structure with curved surfaces (e.g. A wing, fin, or tailplane) designed to give lift in flight.	n, or tailplane) designed to give lift in flight.	
Aeronautics	n.pl. (usu. Treated as sing.) Science or practice of motion in the air.  aeronautic adj. Aeronautical adj. [from *aero-, *nautical]	of motion in the air.  aeronautic adj. Aeronautical adj. [from *aero-, *nautical]	
Aeroplane	n. Powered heavier-than-air flying vehicle with fixed wings. [french: related to *aero-, *plane1]	xed wings. [french: related to *aero-, *plane1]	
Aerosol	n. 1 pressurized container releasing a substance as a fine spray. 2 system of minute particles suspended in gas (e.g. Fog or smoke). [from *aero-, *solution]	s a fine spray. 2 system of minute particles suspended in gas (e.g. Fog or smoke). [from *aero-, *solution]	
Aerospace	n. 1 earth's atmosphere and outer space. 2 aviation in this.	n in this.	
Aesthete	n. Person who has or professes a special appreciation of beauty. [greek aisthanomai perceive]	ion of beauty. [greek aisthanomai perceive]	
Aesthete	n. Person who has or professes a special appreciation of beauty. [greek aisthanomai perceive]	ion of beauty. [greek aisthanomai perceive]	
Aesthetic	â€”adj. 1 of or sensitive to beauty. 2 artistic, tasteful. â€”n. (in pl.) Philosophy of beauty, esp. In art.  aesthetically adv. Aestheticism n.	asteful. â€”n. (in pl.) Philosophy of beauty, esp. In art.  aesthetically adv. Aestheticism n.	
Aetiology	n. (us etiology) study of causation or of the causes of disease.  aetiological adj. [greek aitia cause]	es of disease.  aetiological adj. [greek aitia cause]	
Af	abbr. Audio frequency.		
Afar	adv. At or to a distance.		
Affable	adj. 1 friendly. 2 courteous.  affability n. Affably adv. [latin affabilis]	bly adv. [latin affabilis]	
Affair	n. 1 matter, concern, or thing to be attended to (that is my affair). 2 a celebrated or notorious happening. B colloq. Thing or event (puzzling affair). 3 = *love affair. 4 (in pl.) Public or private business. [french Ã  faire to do]	that is my affair). 2 a celebrated or notorious happening. B colloq. Thing or event (puzzling affair). 3 = *love affair. 4 (in pl.) Public or private business. [french Ã  faire to do]	
Affect	v. 1 a produce an effect on. B (of disease etc.) Attack. 2 move emotionally. 3 pretend (affected ignorance). 4 pose as or use for effect (affects the aesthete; affects fancy hats).  affecting adj. Affectingly adv. [latin afficio affect- influence]	ttack. 2 move emotionally. 3 pretend (affected ignorance). 4 pose as or use for effect (affects the aesthete; affects fancy hats).  affecting adj. Affectingly adv. [latin afficio affect- influence]	
Usage	affect should not be confused with effect, meaning â€˜to bring aboutâ€™. Note also that effect is used as a noun as well as a verb.	 â€˜to bring aboutâ€™. Note also that effect is used as a noun as well as a verb.	
Affectation	n. 1 artificial manner. 2 (foll. By of) studied display. 3 pretence.	splay. 3 pretence.	
Affected	adj. 1 pretended, artificial. 2 full of affectation.	n.	
Affection	n. 1 goodwill, fond feeling. 2 disease; diseased condition.	ondition.	
Affectionate	adj. Loving, fond.  affectionately adv.		
Affidavit	n. Written statement confirmed by oath. [latin, = has stated on oath]	has stated on oath]	
Affiliate	â€”v. (-ting) (foll. By to, with) attach, adopt, or connect as a member or branch. â€”n. Affiliated person etc. [latin: related to *filial]	r connect as a member or branch. â€”n. Affiliated person etc. [latin: related to *filial]	
Affiliation	n. Affiliating or being affiliated.		
Affiliation	order  n. Legal order against the supposed father of an illegitimate child for support.	of an illegitimate child for support.	
Affinity	n. (pl. -ies) 1 liking or attraction; feeling of kinship. 2 relationship, esp. By marriage. 3 similarity of structure or character suggesting a relationship. 4 chem. The tendency of certain substances to combine with others. [latin finis border] 	inship. 2 relationship, esp. By marriage. 3 similarity of structure or character suggesting a relationship. 4 chem. The tendency of certain substances to combine with others. [latin finis border] 	
Affirm	v. 1 assert, state as a fact. 2 law make a solemn declaration in place of an oath.  affirmation n. [latin: related to *firm1]	declaration in place of an oath.  affirmation n. [latin: related to *firm1]	
Affirmative	â€”adj. Affirming; expressing approval. â€”n. Affirmative statement or word etc.	rmative statement or word etc.	
Affix	â€”v. 1 attach, fasten. 2 add in writing. â€”n. 1 addition. 2 gram. Prefix or suffix. [latin: related to *fix]	addition. 2 gram. Prefix or suffix. [latin: related to *fix]	
Afflict	v. Distress physically or mentally. [latin fligo flict- strike down]	lict- strike down]	
Affliction	n. 1 distress, suffering. 2 cause of this.		
Affluent	adj. Wealthy, rich.  affluence n. [latin: related to *fluent]	 to *fluent]	
Afford	v. 1 (prec. By can or be able to) a have enough money, time, etc., for; be able to spare. B be in a position (can't afford to be critical). 2 provide (affords a view of the sea). [old english ge- prefix implying completeness, *forth]	ney, time, etc., for; be able to spare. B be in a position (can't afford to be critical). 2 provide (affords a view of the sea). [old english ge- prefix implying completeness, *forth]	
Afforest	v. 1 convert into forest. 2 plant with trees.  afforestation n. [latin: related to *forest]	forestation n. [latin: related to *forest]	
Affray	n. Breach of the peace by fighting or rioting in public. [anglo-french = â€˜remove from peaceâ€™]	ublic. [anglo-french = â€˜remove from peaceâ€™]	
Affront	â€”n. Open insult. â€”v. Insult openly; offend, embarrass. [latin: related to *front]	barrass. [latin: related to *front]	
Afghan	â€”n. 1 a native or national of afghanistan. B person of afghan descent. 2 official language of afghanistan. â€”adj. Of afghanistan. [pashto]	son of afghan descent. 2 official language of afghanistan. â€”adj. Of afghanistan. [pashto]	
Afghan	hound  n. Tall hunting dog with long silky hair.		
Aficionado	n. (pl. -s) devotee of a sport or pastime. [spanish]	h]	
Afield	adv. To or at a distance (esp. Far afield). [old english: related to *a2]	nglish: related to *a2]	
Aflame	adv. & predic.adj. 1 in flames. 2 very excited.		
Afloat	adv. & predic.adj. 1 floating. 2 at sea. 3 out of debt or difficulty. 4 current. [old english: related to *a2]	debt or difficulty. 4 current. [old english: related to *a2]	
Afoot	adv. & predic.adj. In operation; progressing.		
Afore	prep. & adv. Archaic before; previously; in front (of). [old english: related to *a2]	(of). [old english: related to *a2]	
Afore-	comb. Form before, previously (aforementioned; aforesaid).	resaid).	
Afore	prep. & adv. Archaic before; previously; in front (of). [old english: related to *a2]	(of). [old english: related to *a2]	
Afore-	comb. Form before, previously (aforementioned; aforesaid).	resaid).	
Aforethought	adj. Premeditated (following a noun: malice aforethought).	hought).	
Afraid	predic. Adj. Alarmed, frightened.  be afraid colloq. Politely regret (i'm afraid we're late). [originally past part. Of *affray]	oq. Politely regret (i'm afraid we're late). [originally past part. Of *affray]	
Afresh	adv. Anew; with a fresh beginning. [earlier of fresh]	sh]	
African	â€”n. 1 native (esp. Dark-skinned) of africa. 2 person of african descent. â€”adj. Of africa. [latin]	rson of african descent. â€”adj. Of africa. [latin]	
African	elephant  n. The elephant of africa, larger than that of india.	hat of india.	
African	violet  n. House-plant with velvety leaves and blue, purple, or pink flowers.	e, purple, or pink flowers.	
Afrikaans	n. Language derived from dutch, used in s. Africa. [dutch, = â€˜africanâ€™]	 [dutch, = â€˜africanâ€™]	
Afrikaner	n. Afrikaans-speaking white person in s. Africa, esp. Of dutch descent.	sp. Of dutch descent.	
Afro	â€”adj. (of hair) tightly-curled and bushy. â€”n. (pl. -s) afro hairstyle.	(pl. -s) afro hairstyle.	
Afro-	comb. Form african.		
Afro-american	â€”adj. Of american blacks or their culture. â€”n. American black.	 American black.	
Afro-caribbean	â€”n. Caribbean person of african descent. â€”adj. Of afro-caribbeans.	 Of afro-caribbeans.	
Aft	adv. Naut. & aeron. At or towards the stern or tail. [earlier baft]	l. [earlier baft]	
After	â€”prep. 1 following in time; later than (after a week). 2 in view of, in spite of (after what you did what do you expect?; after all my efforts i still lost). 3 behind (shut the door after you). 4 in pursuit or quest of (run after them). 5 about, concerning (asked after her). 6 in allusion to (named after the prince). 7 in imitation of (a painting after rubens). 8 next in importance to (best one after mine). â€”conj. Later than (left after they arrived). â€”adv. 1 later (soon after). 2 behind (followed on after). â€”adj. 1 later, following (in after years). 2 naut. Nearer the stern (after cabins).  after all in spite of everything (after all, what does it matter?). After one's own heart to one's taste. [old english]	week). 2 in view of, in spite of (after what you did what do you expect?; after all my efforts i still lost). 3 behind (shut the door after you). 4 in pursuit or quest of (run after them). 5 about, concerning (asked after her). 6 in allusion to (named after the prince). 7 in imitation of (a painting after rubens). 8 next in importance to (best one after mine). â€”conj. Later than (left after they arrived). â€”adv. 1 later (soon after). 2 behind (followed on after). â€”adj. 1 later, following (in after years). 2 naut. Nearer the stern (after cabins).  after all in spite of everything (after all, what does it matter?). After one's own heart to one's taste. [old english]	 after rubens). 8 next in importance to (best one after mine). â€”conj. Later than (left after they arrived). â€”adv. 1 later (soon after). 2 behind (followed on after). â€”adj. 1 later, following (in after years). 2 naut. Nearer the stern (after cabins).  after all in spite of everything (after all, what does it matter?). After one's own heart to one's taste. [old english]
Afterbirth	n. Placenta etc. Discharged from the womb after childbirth.	ildbirth.	
After-care	n. Attention after leaving hospital etc.		
After-effect	n. Delayed effect following an accidenA	A-  prefix (also an- before a vowel sound) not, without (amoral). [greek]	thout (amoral). [greek]	ticular area.  zonal adj. [greek zone girdle]
Aa	abbr. 1 automobile association. 2 alcoholics anonymous. 3 anti-aircraft.	mous. 3 anti-aircraft.	 reverse of the normal or desirable orientation or sequence etc.  wrongly adv. Wrongness n. [old english]
Aardvark	n. Mammal with a tubular snout and a long tongue, feeding on termites. [afrikaans]	feeding on termites. [afrikaans]	otion. 2 changed or a change of direction or tendency (took a sudden turn to the left). 3 point at which a turning or change occurs. 4 turning of a road. 5 change of direction of the tide. 6 change in the course of events (a turn for the worse). 7 tendency or disposition; facility of forming (is of a mechanical turn of mind; has a neat turn of phrase). 8 opportunity or obligation etc. That comes successively to each of several persons etc. (my turn to pay). 9 short walk or ride (took a turn in the park). 10 short performance, variety act. 11 service of a specified kind (did me a good turn). 12 purpose (served my turn). 13 colloq. Momentary nervous shock (gave me a turn). 14 mus. Ornament consisting of the principal note with those above and below it.  at every turn continually. By turns in rotation; alternately. In turn in succession. In one's turn when one's turn comes.
Ab-	prefix off, away, from (abduct). [latin]	r obligation etc. That comes successively to each of several persons etc. (my turn to pay). 9 short walk or ride (took a turn in the park). 10 short performance, variety act. 11 service of a specified kind (did me a good turn). 12 purpose (served my turn). 13 colloq. Momentary nervous shock (gave me a turn). 14 mus. Ornament consisting of the principal note with those above and below it.  at every turn continually. By turns in rotation; alternately. In turn in succession. In one's turn when one's turn comes.	 a turn). 14 mus. Ornament consisting of the principal note with those above and below it.  at every turn continually. By turns in rotation; alternately. In turn in succession. In one's turn when one's turn comes.
Aback	adv.  take aback surprise, disconcert. [old english: related to *a2]	sh: related to *a2]	e (did you take that in?). 5 cheat. 6 include. 7 colloq. Visit (a place) on the way to another (took in bath). 8 absorb into the body. Take in hand 1 undertake; start doing or dealing with. 2 undertake to control or reform (a person). Take into account see *account. Take it 1 (often foll. By that) assume. 2 colloq. Endure in a specified way (took it badly). Take it easy see *easy. Take it into one's head see *head. Take it on one (or oneself) (foll. By to + infin.) Venture or presume. Take it or leave it (esp. In imper.) Accept it or not. Take it out of 1 exhaust the strength of. 2 have revenge on. Take it out on relieve one's frustration by treating aggressively.
Abacus	n. (pl. -cuses) 1 frame with wires along which beads are slid for calculating. 2 archit. Flat slab on top of a capital. [latin from greek from hebrew]	ds are slid for calculating. 2 archit. Flat slab on top of a capital. [latin from greek from hebrew]	y.
Abaft	naut. â€”adv. In the stern half of a ship. â€”prep. Nearer the stern than. [from *a2, -baft: see *aft]	. Nearer the stern than. [from *a2, -baft: see *aft]	
Abandon	â€”v. 1 give up. 2 forsake, desert. 3 (often foll. By to; often refl.) Yield to a passion, another's control, etc. â€”n. Freedom from inhibitions.  abandonment n. [french: related to *ad-, *ban]	 By to; often refl.) Yield to a passion, another's control, etc. â€”n. Freedom from inhibitions.  abandonment n. [french: related to *ad-, *ban]	
Abandoned	adj. 1 deserted, forsaken. 2 unrestrained, profligate.	ate.	
Abase	v. (-sing) (also refl.) Humiliate, degrade.  abasement n. [french: related to *ad-, *base2]	ement n. [french: related to *ad-, *base2]	
Abashed	predic. Adj. Embarrassed, disconcerted. [french es- *ex-1, baÃ¯r astound]	- *ex-1, baÃ¯r astound]	
Abate	v. (-ting) make or become less strong etc.; diminish.  abatement n. [french abatre from latin batt(u)o beat]	sh.  abatement n. [french abatre from latin batt(u)o beat]	
Abattoir	n. Slaughterhouse. [french abatre fell, as *abate]		
Abbacy	n. (pl. -ies) office or jurisdiction of an abbot or abbess. [latin: related to *abbot]	r abbess. [latin: related to *abbot]	
AbbÃ©	n. (in france) abbot or priest. [french from latin: related to *abbot]	: related to *abbot]	
Abbess	n. Head of a community of nuns.		
Abbey	n. (pl. -s) 1 building(s) occupied by a community of monks or nuns. 2 the community itself. 3 building that was once an abbey.	of monks or nuns. 2 the community itself. 3 building that was once an abbey.	
Abbot	n. Head of a community of monks. [old english from latin abbas]	 latin abbas]	
Abbreviate	v. (-ting) shorten, esp. Represent (a word etc.) By a part of it.  abbreviation n. [latin: related to *brief]	y a part of it.  abbreviation n. [latin: related to *brief]	
Abc	n. 1 the alphabet. 2 rudiments of a subject. 3 alphabetical guide.	habetical guide.	
Abdicate	v. (-ting) 1 (usu. Absol.) Give up or renounce (the throne). 2 renounce (a duty, right, etc.).  abdication n. [latin dico declare]	e throne). 2 renounce (a duty, right, etc.).  abdication n. [latin dico declare]	
Abdomen	n. 1 the belly, including the stomach, bowels, etc. 2 the hinder part of an insect etc.  abdominal adj. [latin]	. 2 the hinder part of an insect etc.  abdominal adj. [latin]	
Abduct	v. Carry off or kidnap illegally.  abduction n. Abductor n. [latin duco lead]	bductor n. [latin duco lead]	
Abeam	adv. At right angles to a ship's or an aircraft's length.	length.	
Aberdeen	angus  n. Animal of a scottish breed of hornless black cattle. [aberdeen in scotland]	lack cattle. [aberdeen in scotland]	
Aberdonian	â€”adj. Of aberdeen. â€”n. Native or citizen of aberdeen. [medieval latin]	erdeen. [medieval latin]	
Aberrant	adj. Deviating from what is normal or accepted. [latin: related to *err]	atin: related to *err]	
Aberration	n. 1 aberrant behaviour; moral or mental lapse. 2 biol. Deviation from a normal type. 3 distortion of an image because of a defect in a lens or mirror. 4 astron. Apparent displacement of a celestial body.	biol. Deviation from a normal type. 3 distortion of an image because of a defect in a lens or mirror. 4 astron. Apparent displacement of a celestial body.	
Abet	v. (-tt-) (usu. In aid and abet) encourage or assist (an offender or offence). [french: related to *ad-, *bait]	st (an offender or offence). [french: related to *ad-, *bait]	
Abeyance	n. (usu. Prec. By in, into) temporary disuse. [french: related to *ad-, beer gape]	nch: related to *ad-, beer gape]	
Abhor	v. (-rr-) detest; regard with disgust. [latin: related to *horror	ated to *horror	
Abhorrence	n. Disgust; detestation.		
Abhorrent	adj. (often foll. By to) disgusting or hateful.		
Abide	v. (-ding; past abided or rarely abode) 1 (usu. In neg.) Tolerate, endure (can't abide him). 2 (foll. By by) a act in accordance with (abide by the rules). B keep (a promise). 3 archaic remain, continue. [old english a- intensive prefix, *bide]	 neg.) Tolerate, endure (can't abide him). 2 (foll. By by) a act in accordance with (abide by the rules). B keep (a promise). 3 archaic remain, continue. [old english a- intensive prefix, *bide]	
Abiding	adj. Enduring, permanent.		
Ability	n. (pl. -ies) 1 (often foll. By to + infin.) Capacity or power. 2 cleverness, talent. [french: related to *able]	ity or power. 2 cleverness, talent. [french: related to *able]	
-ability	suffix forming nouns of quality from, or corresponding to, adjectives in -able.	ding to, adjectives in -able.	
Ab	initio  adv. From the beginning. [latin]		
Abject	adj. Miserable, wretched; degraded; despicable.  abjection n. [latin jacio -ject- throw]	abjection n. [latin jacio -ject- throw]	
Abjure	v. (-ring) renounce on oath (an opinion, cause, etc.).  abjuration n. [latin juro swear]	c.).  abjuration n. [latin juro swear]	
Ablative	gram. â€”n. Case (in latin) of nouns and pronouns indicating an agent, instrument, or location. â€”adj. Of or in the ablative. [latin ablatus taken away]	indicating an agent, instrument, or location. â€”adj. Of or in the ablative. [latin ablatus taken away]	
Ablaze	predic. Adj. & adv. 1 on fire. 2 glittering, glowing. 3 greatly excited.	ng. 3 greatly excited.	
Able	adj. (abler, ablest) 1 (often foll. By to + infin.; used esp. In is able, will be able, etc., replacing tenses of can) having the capacity or power (not able to come). 2 talented, clever.  ably adv. [latin habilis]	; used esp. In is able, will be able, etc., replacing tenses of can) having the capacity or power (not able to come). 2 talented, clever.  ably adv. [latin habilis]	
-able	suffix forming adjectives meaning: 1 that may or must be (eatable; payable). 2 that can be made the subject of (dutiable; objectionable). 3 relevant to or in accordance with (fashionable; seasonable). [latin -abilis]	ust be (eatable; payable). 2 that can be made the subject of (dutiable; objectionable). 3 relevant to or in accordance with (fashionable; seasonable). [latin -abilis]	
Able-bodied	adj. Fit, healthy.		
Able-bodied	seaman  n. Ordinary trained seaman.		
Ablution	n. (usu. In pl.) 1 ceremonial washing of the hands, sacred vessels, etc. 2 colloq. A ordinary bodily washing. B place for this. [latin ablutio from luo lut- wash]	, sacred vessels, etc. 2 colloq. A ordinary bodily washing. B place for this. [latin ablutio from luo lut- wash]	
-ably	suffix forming adverbs corresponding to adjectives in -able.	 in -able.	
Abm	abbr. Anti-ballistic missile.		
Abnegate	v. (-ting) give up or renounce (a pleasure or right etc.). [latin nego deny]	t etc.). [latin nego deny]	
Abnegation	n. Denial; renunciation of a doctrine.		
Abnormal	adj. Deviating from the norm; exceptional.  abnormality n. (pl. -ies). Abnormally adv. [french: related to *anomalous]	mality n. (pl. -ies). Abnormally adv. [french: related to *anomalous]	
Abo	(also abo) austral. Slang usu. Offens. â€”n. (pl. -s) aboriginal. â€”adj. Aboriginal. [abbreviation]	-s) aboriginal. â€”adj. Aboriginal. [abbreviation]	
Aboard	adv. & prep. On or into (a ship, aircraft, etc.). [from *a2]	[from *a2]	
Abode1	n. Dwelling-place. [related to *abide]		
Abode2	see *abide.		
Abolish	v. Put an end to (esp. A custom or institution). [latin aboleo destroy]	latin aboleo destroy]	
Abolition	n. Abolishing or being abolished.  abolitionist n.	.	
A-bomb	n. = *atomic bomb. [a for *atomic]		
Abominable	adj. 1 detestable, loathsome. 2 colloq. Very unpleasant (abominable weather).  abominably adv. [latin abominor deprecate]	asant (abominable weather).  abominably adv. [latin abominor deprecate]	
Abominable	snowman  n. Supposed manlike or bearlike himalayan animal; yeti.	 animal; yeti.	
Abominate	v. (-ting) detest, loathe.  abomination n. [latin: related to *abominable]	: related to *abominable]	
Aboriginal	â€”adj. 1 indigenous, inhabiting a land from the earliest times, esp. Before the arrival of colonists. 2 (usu. Aboriginal) of australian aborigines. â€”n. 1 aboriginal inhabitant. 2 (usu. Aboriginal) aboriginal inhabitant of australia. [latin: related to *origin]	arliest times, esp. Before the arrival of colonists. 2 (usu. Aboriginal) of australian aborigines. â€”n. 1 aboriginal inhabitant. 2 (usu. Aboriginal) aboriginal inhabitant of australia. [latin: related to *origin]	
Aborigine	n. (usu. In pl.) 1 aboriginal inhabitant. 2 (usu. Aborigine) aboriginal inhabitant of australia.	Aborigine) aboriginal inhabitant of australia.	
Usage	when referring to the people, aboriginal is preferred for the singular form and aborigines for the plural, although aboriginals is also acceptable.	red for the singular form and aborigines for the plural, although aboriginals is also acceptable.	
Abort	v. 1 miscarry. 2 a effect abortion of (a foetus). B effect abortion in (a mother). 3 end or cause (a project etc.) To end before completion. [latin orior be born]	B effect abortion in (a mother). 3 end or cause (a project etc.) To end before completion. [latin orior be born]	
Abortion	n. 1 natural or (esp.) Induced expulsion of a foetus from the womb before it is able to survive independently. 2 stunted or deformed creature or thing. 3 failed project or action.  abortionist n.	us from the womb before it is able to survive independently. 2 stunted or deformed creature or thing. 3 failed project or action.  abortionist n.	
Aboriginal	â€”adj. 1 indigenous, inhabiting a land from the earliest times, esp. Before the arrival of colonists. 2 (usu. Aboriginal) of australian aborigines. â€”n. 1 aboriginal inhabitant. 2 (usu. Aboriginal) aboriginal inhabitant of australia. [latin: related to *origin]	arliest times, esp. Before the arrival of colonists. 2 (usu. Aboriginal) of australian aborigines. â€”n. 1 aboriginal inhabitant. 2 (usu. Aboriginal) aboriginal inhabitant of australia. [latin: related to *origin]	
Aborigine	n. (usu. In pl.) 1 aboriginal inhabitant. 2 (usu. Aborigine) aboriginal inhabitant of australia.	Aborigine) aboriginal inhabitant of australia.	
Usage	when referring to the people, aboriginal is preferred for the singular form and aborigines for the plural, although aboriginals is also acceptable.	red for the singular form and aborigines for the plural, although aboriginals is also acceptable.	
Abort	v. 1 miscarry. 2 a effect abortion of (a foetus). B effect abortion in (a mother). 3 end or cause (a project etc.) To end before completion. [latin orior be born]	B effect abortion in (a mother). 3 end or cause (a project etc.) To end before completion. [latin orior be born]	
Abortion	n. 1 natural or (esp.) Induced expulsion of a foetus from the womb before it is able to survive independently. 2 stunted or deformed creature or thing. 3 failed project or action.  abortionist n.	us from the womb before it is able to survive independently. 2 stunted or deformed creature or thing. 3 failed project or action.  abortionist n.	
Abortive	adj. Fruitless, unsuccessful.		
Abound	v. 1 be plentiful. 2 (foll. By in, with) be rich; teem. [latin unda wave]	teem. [latin unda wave]	
About	â€”prep. 1 a on the subject of (a book about birds). B relating to (glad about it). C in relation to (symmetry about a plane). 2 at a time near to (about six). 3 a in, round (walked about the town; a scarf about her neck). B all round from a centre (look about you). 4 at points in (strewn about the house). 5 carried with (no money about me). 6 occupied with (about her business). â€”adv. 1 a approximately (about ten miles). B colloq. In an understatement (just about had enough). 2 nearby (a lot of flu about). 3 in every direction (look about). 4 on the move; in action (out and about). 5 in rotation or succession (turn and turn about).  be about (or all about) colloq. Have as its essential nature (life is all about having fun). Be about to be on the point of (was about to laugh). [old english]	). B relating to (glad about it). C in relation to (symmetry about a plane). 2 at a time near to (about six). 3 a in, round (walked about the town; a scarf about her neck). B all round from a centre (look about you). 4 at points in (strewn about the house). 5 carried with (no money about me). 6 occupied with (about her business). â€”adv. 1 a approximately (about ten miles). B colloq. In an understatement (just about had enough). 2 nearby (a lot of flu about). 3 in every direction (look about). 4 on the move; in action (out and about). 5 in rotation or succession (turn and turn about).  be about (or all about) colloq. Have as its essential nature (life is all about having fun). Be about to be on the point of (was about to laugh). [old english]	pied with (about her business). â€”adv. 1 a approximately (about ten miles). B colloq. In an understatement (just about had enough). 2 nearby (a lot of flu about). 3 in every direction (look about). 4 on the move; in action (out and about). 5 in rotation or succession (turn and turn about).  be about (or all about) colloq. Have as its essential nature (life is all about having fun). Be about to be on the point of (was about to laugh). [old english]
About-face	n. & int. = *about-turn, about turn.	out having fun). Be about to be on the point of (was about to laugh). [old english]	
About-turn	â€”n. 1 turn made so as to face the opposite direction. 2 change of opinion or policy etc. â€”int. (about turn) mil. Command to make an about-turn.	tion. 2 change of opinion or policy etc. â€”int. (about turn) mil. Command to make an about-turn.	
Above	â€”prep. 1 over; on the top of; higher than; over the surface of (head above water; above the din). 2 more than (above twenty people). 3 higher in rank, importance, etc., than. 4 a too great or good for (not above cheating). B beyond the reach of (above my understanding; above suspicion). â€”adv. 1 at or to a higher point; overhead (the floor above; the sky above). 2 earlier on a page or in a book (as noted above). â€”adj. Preceding (the above argument). â€”n. (prec. By the) preceding text (the above shows).  above all most of all, more than anything else. Above oneself conceited, arrogant. [old english: related to *a2]	the surface of (head above water; above the din). 2 more than (above twenty people). 3 higher in rank, importance, etc., than. 4 a too great or good for (not above cheating). B beyond the reach of (above my understanding; above suspicion). â€”adv. 1 at or to a higher point; overhead (the floor above; the sky above). 2 earlier on a page or in a book (as noted above). â€”adj. Preceding (the above argument). â€”n. (prec. By the) preceding text (the above shows).  above all most of all, more than anything else. Above oneself conceited, arrogant. [old english: related to *a2]	; the sky above). 2 earlier on a page or in a book (as noted above). â€”adj. Preceding (the above argument). â€”n. (prec. By the) preceding text (the above shows).  above all most of all, more than anything else. Above oneself conceited, arrogant. [old english: related to *a2]
Above-board	adj. & adv. Without concealment; open or openly.		
Abracadabra	â€”int. Supposedly magic word used in conjuring. â€”n. Spell or charm. [latin from greek]	€”n. Spell or charm. [latin from greek]	
Abrade	v. (-ding) scrape or wear away (skin, rock, etc.) By rubbing. [latin rado scrape]	By rubbing. [latin rado scrape]	
Abrasion	n. 1 scraping or wearing away (of skin, rock, etc.). 2 resulting damaged area.	). 2 resulting damaged area.	
Abrasive	â€”adj. 1 a tending to rub or graze. B capable of polishing by rubbing or grinding. 2 harsh or hurtful in manner. â€”n. Abrasive substance.	polishing by rubbing or grinding. 2 harsh or hurtful in manner. â€”n. Abrasive substance.	
Abreast	adv. 1 side by side and facing the same way. 2 (foll. By of) up to date.	ll. By of) up to date.	
Abridge	v. (-ging) shorten (a book, film, etc.).  abridgement n. [latin: related to *abbreviate]	ment n. [latin: related to *abbreviate]	
Abroad	adv. 1 in or to a foreign country or countries. 2 widely (scatter abroad). 3 in circulation (rumour abroad).	widely (scatter abroad). 3 in circulation (rumour abroad).	
Abrogate	v. (-ting) repeal, abolish (a law etc.).  abrogation n. [latin rogo propose a law]	ion n. [latin rogo propose a law]	
Abrupt	adj. 1 sudden, hasty (abrupt end). 2 (of manner etc.) Curt. 3 steep, precipitous.  abruptly adv. Abruptness n. [latin: related to *rupture]	c.) Curt. 3 steep, precipitous.  abruptly adv. Abruptness n. [latin: related to *rupture]	
Abscess	n. (pl. Abscesses) swelling containing pus. [latin: related to *ab-, *cede]	: related to *ab-, *cede]	
Abseil	â€”v. Descend by using a doubled rope coiled round the body and fixed at a higher point. â€”n. Descent made by abseiling. [german ab down, seil rope]	 the body and fixed at a higher point. â€”n. Descent made by abseiling. [german ab down, seil rope]	
Absence	n. 1 being away. 2 time of this. 3 (foll. By of) lack of.  absence of mind inattentiveness. [latin absentia]	ack of.  absence of mind inattentiveness. [latin absentia]	
Absent	â€”adj. 1 not present. 2 not existing; lacking. 3 inattentive. â€”v.refl. Go, or stay, away.  absently adv. (in sense 3 of adj.).	inattentive. â€”v.refl. Go, or stay, away.  absently adv. (in sense 3 of adj.).	
Absentee	n. Person not present.		
Absenteeism	n. Absenting oneself from work or school etc., esp. Frequently or illicitly.	. Frequently or illicitly.	
Absentee	landlord  n. One who lets a property while living elsewhere.	elsewhere.	
Absent-minded	adj. Forgetful or inattentive.  absent-mindedly adv. Absent-mindedness n.	dv. Absent-mindedness n.	
Absinth	n. 1 wormwood. 2 (usu. Absinthe) aniseed-flavoured liqueur based on this. [french from latin]	 liqueur based on this. [french from latin]	
Absolute	â€”adj. 1 complete, utter (absolute bliss). 2 unconditional (absolute authority). 3 despotic (absolute monarch). 4 not relative or comparative (absolute standard). 5 gram. A (of a construction) syntactically independent of the rest of the sentence, as in dinner being over, we left the table. B (of an adjective or transitive verb) without an expressed noun or object (e.g. The deaf, guns kill). 6 (of a legal decree etc.) Final. â€”n. Philos. (prec. By the) that which can exist independently of anything else. [latin: related to *absolve]	nditional (absolute authority). 3 despotic (absolute monarch). 4 not relative or comparative (absolute standard). 5 gram. A (of a construction) syntactically independent of the rest of the sentence, as in dinner being over, we left the table. B (of an adjective or transitive verb) without an expressed noun or object (e.g. The deaf, guns kill). 6 (of a legal decree etc.) Final. â€”n. Philos. (prec. By the) that which can exist independently of anything else. [latin: related to *absolve]	ed noun or object (e.g. The deaf, guns kill). 6 (of a legal decree etc.) Final. â€”n. Philos. (prec. By the) that which can exist independently of anything else. [latin: related to *absolve]
Absolutely	adv. 1 completely, utterly. 2 in an absolute sense (god exists absolutely). 3  colloq. (used in reply) quite so; yes.	 (god exists absolutely). 3  colloq. (used in reply) quite so; yes.	
Absolute	majority  n. Majority over all rivals combined.		
Absolute	pitch  n. Ability to recognize or sound any given note.	note.	
Absolute	temperature  n. One measured from absolute zero.		
Absolute	zero  n. Theoretical lowest possible temperature calculated as â€“273.15Â° c (or 0Â° k).	alculated as â€“273.15Â° c (or 0Â° k).	
Absolution	n. Formal forgiveness of sins.		
Absolutism	n. Principle or practice of absolute government.  absolutist n.	 absolutist n.	
Absolve	v. (-ving) (often foll. By from, of) set or pronounce free from blame or obligation etc. [latin: related to *solve]	nce free from blame or obligation etc. [latin: related to *solve]	
Absorb	v. 1 incorporate as part of itself or oneself. 2 take in, suck up (liquid, heat, knowledge, etc.). 3 reduce the effect or intensity of; deal easily with (an impact, sound, difficulty, etc.). 4 consume (resources etc.). 5 (often as absorbing adj.) Engross the attention of. [latin sorbeo suck in]	ake in, suck up (liquid, heat, knowledge, etc.). 3 reduce the effect or intensity of; deal easily with (an impact, sound, difficulty, etc.). 4 consume (resources etc.). 5 (often as absorbing adj.) Engross the attention of. [latin sorbeo suck in]	
Absorbent	â€”adj. Tending to absorb. â€”n. Absorbent substance or organ.	ce or organ.	
Absorption	n. 1 absorbing or being absorbed. 2 mental engrossment.  absorptive adj.	ment.  absorptive adj.	
Abstain	v. 1 (usu. Foll. By from) refrain from indulging (abstained from smoking). 2 decline to vote. [latin teneo tent- hold]	abstained from smoking). 2 decline to vote. [latin teneo tent- hold]	
Abstemious	adj. Moderate or ascetic, esp. In eating and drinking.  abstemiously adv. [latin: related to *ab-, temetum strong drink]	ing.  abstemiously adv. [latin: related to *ab-, temetum strong drink]	
Abstention	n. Abstaining, esp. From voting. [latin: related to *abstain]	o *abstain]	
Abstinence	n. Abstaining, esp. From food or alcohol.  abstinent adj. [french: related to *abstain]	ent adj. [french: related to *abstain]	
Abstract	â€”adj. 1 a of or existing in thought or theory rather than matter or practice; not concrete. B (of a word, esp. A noun) denoting a quality, condition, etc., not a concrete object. 2 (of art) achieving its effect by form and colour rather than by realism. â€”v. 1 (often foll. By from) extract, remove. 2 summarize. â€”n. 1 summary. 2 abstract work of art. 3 abstraction or abstract term. [latin: related to *tract1]	ther than matter or practice; not concrete. B (of a word, esp. A noun) denoting a quality, condition, etc., not a concrete object. 2 (of art) achieving its effect by form and colour rather than by realism. â€”v. 1 (often foll. By from) extract, remove. 2 summarize. â€”n. 1 summary. 2 abstract work of art. 3 abstraction or abstract term. [latin: related to *tract1]	f art. 3 abstraction or abstract term. [latin: related to *tract1]
Abstracted	adj. Inattentive, distracted.  abstractedly adv.		
Abstraction	n. 1 abstracting or taking away. 2 abstract or visionary idea. 3 abstract qualities (esp. In art). 4 absent-mindedness.	ionary idea. 3 abstract qualities (esp. In art). 4 absent-mindedness.	
Abstruse	adj. Hard to understand, profound. [latin abstrudo -trus- conceal]	 -trus- conceal]	
Absurd	adj. Wildly illogical or inappropriate; ridiculous.  absurdity n. (pl. -ies). Absurdly adv. [latin: related to *surd]	.  absurdity n. (pl. -ies). Absurdly adv. [latin: related to *surd]	
Abta	abbr. Association of british travel agents.		
Abundance	n. 1 plenty; more than enough; a lot. 2 wealth. [latin: related to *abound]	atin: related to *abound]	
Abundance	n. 1 plenty; more than enough; a lot. 2 wealth. [latin: related to *abound]	atin: related to *abound]	
Abundant	adj. 1 plentiful. 2 (foll. By in) rich (abundant in fruit).  abundantly adv.	n fruit).  abundantly adv.	
Abuse	â€”v. (-sing) 1 use improperly, misuse. 2 insult verbally. 3 maltreat. â€”n. 1 misuse. 2 insulting language. 3 unjust or corrupt practice. 4 maltreatment (child abuse).  abuser n. [latin: related to *use]	erbally. 3 maltreat. â€”n. 1 misuse. 2 insulting language. 3 unjust or corrupt practice. 4 maltreatment (child abuse).  abuser n. [latin: related to *use]	
Abusive	adj. Insulting, offensive.  abusively adv.		
Abut	v. (-tt-) 1 (foll. By on) (of land) border on. 2 (foll. By on, against) (of a building) touch or lean upon (another). [anglo-latin butta strip of land: related to *butt1]	foll. By on, against) (of a building) touch or lean upon (another). [anglo-latin butta strip of land: related to *butt1]	
Abutment	n. Lateral supporting structure of a bridge, arch, etc.	 etc.	
Abuzz	adv. & adj. In a state of excitement or activity.		
Abysmal	adj. 1 colloq. Extremely bad (abysmal food). 2 profound, utter (abysmal ignorance).  abysmally adv. [latin: related to *abyss]	found, utter (abysmal ignorance).  abysmally adv. [latin: related to *abyss]	
Abyss	n. 1 deep chasm. 2 immeasurable depth (abyss of despair). [latin from greek, = bottomless]	spair). [latin from greek, = bottomless]	
Ac	abbr. 1 (also ac) alternating current. 2 aircraftman.	an.	
Ac	symb. Actinium.		
A/c	abbr. Account. [account current]		
-ac	suffix forming adjectives often (or only) used as nouns (cardiac; maniac). [latin -acus, greek -akos]	nouns (cardiac; maniac). [latin -acus, greek -akos]	
Acacia	n. Tree with yellow or white flowers, esp. One yielding gum arabic. [latin from greek]	lding gum arabic. [latin from greek]	
Academia	n. The academic world; scholastic life.		
Academic	â€”adj. 1 scholarly, of learning. 2 of no practical relevance; theoretical. â€”n. Teacher or scholar in a university etc.  academically adv.	l relevance; theoretical. â€”n. Teacher or scholar in a university etc.  academically adv.	
Academician	n. Member of an academy. [french acadÃ©micien]		
Academy	n. (pl. -ies) 1 place of specialized training (military academy). 2 (usu. Academy) society or institution of distinguished scholars, artists, scientists, etc. (royal academy). 3 scot. Secondary school. [greek akademeia the place in athens where plato taught]	itary academy). 2 (usu. Academy) society or institution of distinguished scholars, artists, scientists, etc. (royal academy). 3 scot. Secondary school. [greek akademeia the place in athens where plato taught]	
Acanthus	n. (pl. -thuses) 1 herbaceous plant with spiny leaves. 2 archit. Representation of its leaf. [latin from greek]	ves. 2 archit. Representation of its leaf. [latin from greek]	
A	cappella  adj. & adv. (of choral music) unaccompanied. [italian, = in church style]	ied. [italian, = in church style]	
Acas	abbr. Advisory, conciliation, and arbitration service.	ice.	
Accede	v. (-ding) (foll. By to) 1 take office, esp. As monarch. 2 assent or agree. [latin: related to *cede]	narch. 2 assent or agree. [latin: related to *cede]	
Accelerate	v. (-ting) move or cause to move or happen more quickly.  acceleration n. [latin: related to *celerity]	ickly.  acceleration n. [latin: related to *celerity]	
Accelerator	n. 1 device for increasing speed, esp. The pedal controlling the speed of a vehicle's engine. 2 physics apparatus for imparting high speeds to charged particles.	ontrolling the speed of a vehicle's engine. 2 physics apparatus for imparting high speeds to charged particles.	
Accent	â€”n. 1 particular (esp. Local or national) mode of pronunciation. 2 distinctive feature or emphasis (accent on speed). 3 prominence given to a syllable by stress or pitch. 4 mark on a letter or word to indicate pitch, stress, or vowel quality. â€”v. 1 emphasize (a word or syllable etc.). 2 write or print accents on (words etc.). 3 accentuate. [latin cantus song]	f pronunciation. 2 distinctive feature or emphasis (accent on speed). 3 prominence given to a syllable by stress or pitch. 4 mark on a letter or word to indicate pitch, stress, or vowel quality. â€”v. 1 emphasize (a word or syllable etc.). 2 write or print accents on (words etc.). 3 accentuate. [latin cantus song]	in cantus song]
Accentuate	v. (-ting) emphasize, make prominent.  accentuation n. [medieval latin: related to *accent]	on n. [medieval latin: related to *accent]	
Accept	v. 1 (also absol.) Willingly receive (a thing offered). 2 (also absol.) Answer affirmatively (an offer etc.). 3 regard favourably; treat as welcome (felt accepted). 4 believe, receive (an opinion, explanation, etc.) As adequate or valid. 5 take as suitable (does accept cheques). 6 undertake (an office or duty). [latin capio take]	red). 2 (also absol.) Answer affirmatively (an offer etc.). 3 regard favourably; treat as welcome (felt accepted). 4 believe, receive (an opinion, explanation, etc.) As adequate or valid. 5 take as suitable (does accept cheques). 6 undertake (an office or duty). [latin capio take]	
Acceptable	adj. 1 worth accepting, welcome. 2 tolerable.  acceptability n. Acceptably adv. [french: related to *accept]	ceptability n. Acceptably adv. [french: related to *accept]	
Acceptance	n. 1 willingness to accept. 2 affirmative answer to an invitation etc. 3 approval, belief (found wide acceptance).	o an invitation etc. 3 approval, belief (found wide acceptance).	
Access	â€”n. 1 way of approach or entry (shop with rear access). 2 a right or opportunity to reach or use or visit; admittance (access to secret files, to the prisoner). B accessibility. 3 archaic outburst (an access of anger). â€”v. 1 computing gain access to (data etc.). 2 accession. [french: related to *accede]	ccess). 2 a right or opportunity to reach or use or visit; admittance (access to secret files, to the prisoner). B accessibility. 3 archaic outburst (an access of anger). â€”v. 1 computing gain access to (data etc.). 2 accession. [french: related to *accede]	
Accessible	adj. (often foll. By to) 1 reachable or obtainable; readily available. 2 easy to understand.  accessibility n.	; readily available. 2 easy to understand.  accessibility n.	
Accession	â€”n. 1 taking office, esp. As monarch. 2 thing added. â€”v. Record the addition of (a new item) to a library etc.	ded. â€”v. Record the addition of (a new item) to a library etc.	
Accessory	n. (pl. -ies) 1 additional or extra thing. 2 (usu. In pl.) Small attachment, fitting, or subsidiary item of dress (e.g. Shoes, gloves). 3 (often foll. By to) person who abets or is privy to an (esp. Illegal) act. [medieval latin: related to *accede]	 In pl.) Small attachment, fitting, or subsidiary item of dress (e.g. Shoes, gloves). 3 (often foll. By to) person who abets or is privy to an (esp. Illegal) act. [medieval latin: related to *accede]	
Access	road  n. Road giving access only to the properties along it.	 along it.	
Access	time  n. Computing time taken to retrieve data from storage.	m storage.	
Accident	n. 1 unfortunate esp. Harmful event, caused unintentionally. 2 event that is unexpected or without apparent cause.  by accident unintentionally. [latin cado fall]	ntionally. 2 event that is unexpected or without apparent cause.  by accident unintentionally. [latin cado fall]	
Accidental	â€”adj. Happening by chance or accident. â€”n. Mus. Sign indicating a note's momentary departure from the key signature.  accidentally adv.	. Sign indicating a note's momentary departure from the key signature.  accidentally adv.	
Accident-prone	adj. Clumsy.		
Acclaim	â€”v. 1 welcome or applaud enthusiastically. 2 hail as (acclaimed him king). â€”n. Applause, welcome, public praise. [latin acclamo: related to *claim]	l as (acclaimed him king). â€”n. Applause, welcome, public praise. [latin acclamo: related to *claim]	
Acclamation	n. 1 loud and eager assent. 2 (usu. In pl.) Shouting in a person's honour.	ng in a person's honour.	
Acclimatize	v. (also -ise) (-zing or -sing) adapt to a new climate or conditions.  acclimatization n. [french acclimater: related to *climate]	mate or conditions.  acclimatization n. [french acclimater: related to *climate]	
Accolade	n. 1 praise given. 2 touch made with a sword at the conferring of a knighthood. [latin collum neck]	e conferring of a knighthood. [latin collum neck]	
Accommodate	v. (-ting) 1 provide lodging or room for (flat accommodates two). 2 adapt, harmonize, reconcile (must accommodate himself to new ideas). 3 a do favour to, oblige (a person). B (foll. By with) supply (a person) with. [latin: related to *commode]	ommodates two). 2 adapt, harmonize, reconcile (must accommodate himself to new ideas). 3 a do favour to, oblige (a person). B (foll. By with) supply (a person) with. [latin: related to *commode]	
Accommodating	adj. Obliging, compliant.		
Accommodation	n. 1 lodgings. 2 adjustment, adaptation. 3 convenient arrangement; settlement, compromise.	ent arrangement; settlement, compromise.	
Accommodation	address  n. Postal address used by a person unable or unwilling to give a permanent address.	 or unwilling to give a permanent address.	
Accompaniment	n. 1 instrumental or orchestral support for a solo instrument, voice, or group. 2 accompanying thing.  accompanist n. (in sense 1).	 instrument, voice, or group. 2 accompanying thing.  accompanist n. (in sense 1).	
Accompany	v. (-ies, -ied) 1 go with; escort. 2 (usu. In passive; foll. By with, by) be done or found with; supplement. 3 mus. Partner with accompaniment. [french: related to *companion]	ive; foll. By with, by) be done or found with; supplement. 3 mus. Partner with accompaniment. [french: related to *companion]	
Accomplice	n. Partner in a crime etc. [latin: related to *complex]	plex]	
Accomplish	v. Succeed in doing; achieve, complete. [latin: related to *complete]	lated to *complete]	
Accomplished	adj. Clever, skilled.		
Accomplishment	n. 1 completion (of a task etc.). 2 acquired, esp. Social, skill. 3 thing achieved.	 Social, skill. 3 thing achieved.	
Accord	â€”v. 1 (often foll. By with) be consistent or in harmony. 2 grant (permission, a request, etc.); give (a welcome etc.). â€”n. 1 agreement, consent. 2 mus. & art etc. Harmony.  of one's own accord on one's own initiative; voluntarily. With one accord unanimously. [latin cor cord- heart]	harmony. 2 grant (permission, a request, etc.); give (a welcome etc.). â€”n. 1 agreement, consent. 2 mus. & art etc. Harmony.  of one's own accord on one's own initiative; voluntarily. With one accord unanimously. [latin cor cord- heart]	
Accordance	n.  in accordance with in conformity to.  accordant adj.	ant adj.	
According	adv. 1 (foll. By to) a as stated by (according to mary). B in proportion to (lives according to his means). 2 (foll. By as + clause) in a manner or to a degree that varies as (pays according as he is able).	mary). B in proportion to (lives according to his means). 2 (foll. By as + clause) in a manner or to a degree that varies as (pays according as he is able).	
Accordingly	adv. 1 as circumstances suggest or require (please act accordingly). 2 consequently (accordingly, he left the room).	 act accordingly). 2 consequently (accordingly, he left the room).	
Accordion	n. Musical reed instrument with concertina-like bellows, keys, and buttons.  accordionist n. [italian accordare to tune]	llows, keys, and buttons.  accordionist n. [italian accordare to tune]	
Accost	v. 1 approach and address (a person), esp. Boldly. 2 (of a prostitute) solicit. [latin costa rib]	 2 (of a prostitute) solicit. [latin costa rib]	
Accession	â€”n. 1 taking office, esp. As monarch. 2 thing added. â€”v. Record the addition of (a new item) to a library etc.	ded. â€”v. Record the addition of (a new item) to a library etc.	
Accessory	n. (pl. -ies) 1 additional or extra thing. 2 (usu. In pl.) Small attachment, fitting, or subsidiary item of dress (e.g. Shoes, gloves). 3 (often foll. By to) person who abets or is privy to an (esp. Illegal) act. [medieval latin: related to *accede]	 In pl.) Small attachment, fitting, or subsidiary item of dress (e.g. Shoes, gloves). 3 (often foll. By to) person who abets or is privy to an (esp. Illegal) act. [medieval latin: related to *accede]	
Access	road  n. Road giving access only to the properties along it.	 along it.	
Access	time  n. Computing time taken to retrieve data from storage.	m storage.	
Accident	n. 1 unfortunate esp. Harmful event, caused unintentionally. 2 event that is unexpected or without apparent cause.  by accident unintentionally. [latin cado fall]	ntionally. 2 event that is unexpected or without apparent cause.  by accident unintentionally. [latin cado fall]	
Accidental	â€”adj. Happening by chance or accident. â€”n. Mus. Sign indicating a note's momentary departure from the key signature.  accidentally adv.	. Sign indicating a note's momentary departure from the key signature.  accidentally adv.	
Accident-prone	adj. Clumsy.		
Acclaim	â€”v. 1 welcome or applaud enthusiastically. 2 hail as (acclaimed him king). â€”n. Applause, welcome, public praise. [latin acclamo: related to *claim]	l as (acclaimed him king). â€”n. Applause, welcome, public praise. [latin acclamo: related to *claim]	
Acclamation	n. 1 loud and eager assent. 2 (usu. In pl.) Shouting in a person's honour.	ng in a person's honour.	
Acclimatize	v. (also -ise) (-zing or -sing) adapt to a new climate or conditions.  acclimatization n. [french acclimater: related to *climate]	mate or conditions.  acclimatization n. [french acclimater: related to *climate]	
Accolade	n. 1 praise given. 2 touch made with a sword at the conferring of a knighthood. [latin collum neck]	e conferring of a knighthood. [latin collum neck]	
Accommodate	v. (-ting) 1 provide lodging or room for (flat accommodates two). 2 adapt, harmonize, reconcile (must accommodate himself to new ideas). 3 a do favour to, oblige (a person). B (foll. By with) supply (a person) with. [latin: related to *commode]	ommodates two). 2 adapt, harmonize, reconcile (must accommodate himself to new ideas). 3 a do favour to, oblige (a person). B (foll. By with) supply (a person) with. [latin: related to *commode]	
Accommodating	adj. Obliging, compliant.		
Accommodation	n. 1 lodgings. 2 adjustment, adaptation. 3 convenient arrangement; settlement, compromise.	ent arrangement; settlement, compromise.	
Accommodation	address  n. Postal address used by a person unable or unwilling to give a permanent address.	 or unwilling to give a permanent address.	
Accompaniment	n. 1 instrumental or orchestral support for a solo instrument, voice, or group. 2 accompanying thing.  accompanist n. (in sense 1).	 instrument, voice, or group. 2 accompanying thing.  accompanist n. (in sense 1).	
Accompany	v. (-ies, -ied) 1 go with; escort. 2 (usu. In passive; foll. By with, by) be done or found with; supplement. 3 mus. Partner with accompaniment. [french: related to *companion]	ive; foll. By with, by) be done or found with; supplement. 3 mus. Partner with accompaniment. [french: related to *companion]	
Accomplice	n. Partner in a crime etc. [latin: related to *complex]	plex]	
Accomplish	v. Succeed in doing; achieve, complete. [latin: related to *complete]	lated to *complete]	
Accomplished	adj. Clever, skilled.		
Accomplishment	n. 1 completion (of a task etc.). 2 acquired, esp. Social, skill. 3 thing achieved.	 Social, skill. 3 thing achieved.	
Accord	â€”v. 1 (often foll. By with) be consistent or in harmony. 2 grant (permission, a request, etc.); give (a welcome etc.). â€”n. 1 agreement, consent. 2 mus. & art etc. Harmony.  of one's own accord on one's own initiative; voluntarily. With one accord unanimously. [latin cor cord- heart]	harmony. 2 grant (permission, a request, etc.); give (a welcome etc.). â€”n. 1 agreement, consent. 2 mus. & art etc. Harmony.  of one's own accord on one's own initiative; voluntarily. With one accord unanimously. [latin cor cord- heart]	
Accordance	n.  in accordance with in conformity to.  accordant adj.	ant adj.	
According	adv. 1 (foll. By to) a as stated by (according to mary). B in proportion to (lives according to his means). 2 (foll. By as + clause) in a manner or to a degree that varies as (pays according as he is able).	mary). B in proportion to (lives according to his means). 2 (foll. By as + clause) in a manner or to a degree that varies as (pays according as he is able).	
Accordingly	adv. 1 as circumstances suggest or require (please act accordingly). 2 consequently (accordingly, he left the room).	 act accordingly). 2 consequently (accordingly, he left the room).	
Accordion	n. Musical reed instrument with concertina-like bellows, keys, and buttons.  accordionist n. [italian accordare to tune]	llows, keys, and buttons.  accordionist n. [italian accordare to tune]	
Accost	v. 1 approach and address (a person), esp. Boldly. 2 (of a prostitute) solicit. [latin costa rib]	 2 (of a prostitute) solicit. [latin costa rib]	
Account	â€”n. 1 narration, description (an account of his trip). 2 arrangement at a bank etc. For depositing and withdrawing money, credit, etc. (open an account). 3 record or statement of financial transactions with the balance (kept detailed accounts). â€”v. Consider as (account him wise, a fool).	trip). 2 arrangement at a bank etc. For depositing and withdrawing money, credit, etc. (open an account). 3 record or statement of financial transactions with the balance (kept detailed accounts). â€”v. Consider as (account him wise, a fool).	
Accountable	adj. 1 responsible; required to account for one's conduct. 2 explicable, understandable.  accountability n.	conduct. 2 explicable, understandable.  accountability n.	
Accountant	n. Professional keeper or verifier of accounts.  accountancy n. Accounting n.	accountancy n. Accounting n.	
Accouterments	n.pl. (brit. Accoutrements) 1 equipment, trappings. 2 soldier's equipment excluding weapons and clothes. [french]	. 2 soldier's equipment excluding weapons and clothes. [french]	
Accoutrements	n.pl. (us accouterments) 1 equipment, trappings. 2 soldier's equipment excluding weapons and clothes. [french]	 soldier's equipment excluding weapons and clothes. [french]	
Accredit	v. (-t-) 1 (foll. By to) attribute (a saying etc.) To (a person). 2 (foll. By with) credit (a person) with (a saying etc.). 3 (usu. Foll. By to or at) send (an ambassador etc.) With credentials. 4 gain influence for or make credible (an adviser, a statement, etc.). [french: related to *credit]	 To (a person). 2 (foll. By with) credit (a person) with (a saying etc.). 3 (usu. Foll. By to or at) send (an ambassador etc.) With credentials. 4 gain influence for or make credible (an adviser, a statement, etc.). [french: related to *credit]	
Accredited	adj. 1 officially recognized. 2 generally accepted.	.	
Accretion	n. 1 growth or increase by accumulation, addition, or organic enlargement. 2 the resulting whole. 3 a matter so added. B adhesion of this to the core matter. [latin cresco cret- grow]	 or organic enlargement. 2 the resulting whole. 3 a matter so added. B adhesion of this to the core matter. [latin cresco cret- grow]	
Accrue	v. (-ues, -ued, -uing) (often foll. By to) come as a natural increase or advantage, esp. Financial. [latin: related to *accretion]	 a natural increase or advantage, esp. Financial. [latin: related to *accretion]	
Accumulate	v. (-ting) 1 acquire an increasing number or quantity of; amass, collect. 2 grow numerous; increase. [latin: related to *cumulus]	ity of; amass, collect. 2 grow numerous; increase. [latin: related to *cumulus]	
Accumulation	n. 1 accumulating or being accumulated. 2 accumulated mass. 3 growth of capital by continued interest.  accumulative adj.	ted mass. 3 growth of capital by continued interest.  accumulative adj.	
Accumulator	n. 1 rechargeable electric cell. 2 bet placed on a sequence of events, with the winnings and stake from each placed on the next.	 sequence of events, with the winnings and stake from each placed on the next.	
Accuracy	n. Exactness or careful precision. [latin cura care]	e]	
Accurate	adj. Careful, precise; conforming exactly with the truth or a standard.  accurately adv.	 truth or a standard.  accurately adv.	
Accursed	adj. 1 under a curse. 2 colloq. Detestable, annoying. [old english a- intensive prefix, *curse]	ng. [old english a- intensive prefix, *curse]	
Accusation	n. Accusing or being accused. [french: related to *accuse]	*accuse]	
Accusative	gram. â€”n. Case expressing the object of an action. â€”adj. Of or in this case.	n. â€”adj. Of or in this case.	
Accusatory	adj. Of or implying accusation.		
Accuse	v. (-sing) (often foll. By of) charge with a fault or crime; blame. [latin accusare: related to *cause]	 or crime; blame. [latin accusare: related to *cause]	
Accustom	v. (foll. By to) make used to (accustomed him to hardship). [french: related to *custom]	ardship). [french: related to *custom]	
Accustomed	adj. 1 (usu. Foll. By to) used to a thing. 2 customary, usual.	mary, usual.	
Ace	â€”n. 1 playing-card etc. With a single spot and generally signifying â€˜oneâ€™. 2 a person who excels in some activity. B pilot who has shot down many enemy aircraft. 3 (in tennis) unreturnable stroke (esp. A service). â€”adj. Slang excellent.  within an ace of on the verge of. [latin as unity]	enerally signifying â€˜oneâ€™. 2 a person who excels in some activity. B pilot who has shot down many enemy aircraft. 3 (in tennis) unreturnable stroke (esp. A service). â€”adj. Slang excellent.  within an ace of on the verge of. [latin as unity]	
Acellular	adj. Having no cells; not consisting of cells.		
Aceous	suffix forming adjectives in the sense â€˜of the nature ofâ€™, esp. In the natural sciences (herbaceous). [latin -aceus]	ature ofâ€™, esp. In the natural sciences (herbaceous). [latin -aceus]	
Acerbic	adj. Harsh and sharp, esp. In speech or manner.  acerbity n. (pl. -ies). [latin acerbus sour]	acerbity n. (pl. -ies). [latin acerbus sour]	
Acetaldehyde	n. Colourless volatile liquid aldehyde. [from *acetic, *aldehyde]	tic, *aldehyde]	
Acetate	n. 1 salt or ester of acetic acid, esp. The cellulose ester. 2 fabric made from this.	ose ester. 2 fabric made from this.	
Acetic	adj. Of or like vinegar. [latin acetum vinegar]		
Acetic	acid  n. Clear liquid acid giving vinegar its characteristic taste.	acteristic taste.	
Acetone	n. Colourless volatile liquid that dissolves organic compounds, esp. Paints, varnishes, etc.	ic compounds, esp. Paints, varnishes, etc.	
Acetylene	n. Hydrocarbon gas burning with a bright flame, used esp. In welding.	ed esp. In welding.	
Ache	â€”n. 1 continuous dull pain. 2 mental distress. â€”v. (-ching) suffer from or be the source of an ache. [old english]	€”v. (-ching) suffer from or be the source of an ache. [old english]	
Achieve	v. (-ving) 1 reach or attain, esp. By effort (achieved victory; achieved notoriety). 2 accomplish (a feat or task). [french achever: related to *chief]	eved victory; achieved notoriety). 2 accomplish (a feat or task). [french achever: related to *chief]	
Achievement	n. 1 something achieved. 2 act of achieving.		
Achilles	heel  n. Person's weak or vulnerable point. [achilles, greek hero in the iliad]	les, greek hero in the iliad]	
Achilles	tendon  n. Tendon connecting the heel with the calf muscles.	f muscles.	
Achromatic	adj. Optics 1 transmitting light without separation into constituent colours (achromatic lens). 2 without colour.  achromatically adv. [french: related to *a-, *chrome]	n into constituent colours (achromatic lens). 2 without colour.  achromatically adv. [french: related to *a-, *chrome]	
Achy	adj. (-ier, -iest) full of or suffering from aches.	.	
Acid	â€”n. 1 a any of a class of substances that liberate hydrogen ions in water, are usu. Sour and corrosive, turn litmus red, and have a ph of less than 7. B any compound or atom donating protons. 2 any sour substance. 3 slang the drug lsd. â€”adj. 1 sour. 2 biting, sharp (an acid wit). 3 chem. Having the essential properties of an acid.  acidic adj. Acidify v. (-ies, -ied). Acidity n. Acidly adv. [latin aceo be sour]	te hydrogen ions in water, are usu. Sour and corrosive, turn litmus red, and have a ph of less than 7. B any compound or atom donating protons. 2 any sour substance. 3 slang the drug lsd. â€”adj. 1 sour. 2 biting, sharp (an acid wit). 3 chem. Having the essential properties of an acid.  acidic adj. Acidify v. (-ies, -ied). Acidity n. Acidly adv. [latin aceo be sour]	 Acidify v. (-ies, -ied). Acidity n. Acidly adv. [latin aceo be sour]
Acid	house  n. A type of synthesized music with a simple repetitive beat, often associated with hallucinogenic drugs.	e repetitive beat, often associated with hallucinogenic drugs.	
Acid	rain  n. Acid, esp. From industrial waste gases, falling with rain.	alling with rain.	
Acid	test  n. Severe or conclusive test.		
Acidulous	adj. Somewhat acid.		
Ack-ack	colloq. â€”adj. Anti-aircraft. â€”n. Anti-aircraft gun etc. [formerly signallers' term for aa]	 gun etc. [formerly signallers' term for aa]	
Acknowledge	v. (-ging) 1 recognize; accept the truth of (acknowledged its failure). 2 confirm the receipt of (a letter etc.). 3 a show that one has noticed (acknowledged my arrival with a grunt). B express appreciation of (a service etc.). 4 recognize the validity of, own (the acknowledged king). [from *ad-, *knowledge]	wledged its failure). 2 confirm the receipt of (a letter etc.). 3 a show that one has noticed (acknowledged my arrival with a grunt). B express appreciation of (a service etc.). 4 recognize the validity of, own (the acknowledged king). [from *ad-, *knowledge]	
Acknowledgement	n. 1 act of acknowledging. 2 a thing given or done in gratitude. B letter confirming receipt of something. 3 (usu. In pl.) Author's statement of gratitude, prefacing a book.	 in gratitude. B letter confirming receipt of something. 3 (usu. In pl.) Author's statement of gratitude, prefacing a book.	
Acme	n. Highest point (of achievement etc.). [greek]		
Acne	n. Skin condition with red pimples. [latin]		
Acolyte	n. 1 person assisting a priest. 2 assistant; beginner. [greek akolouthos follower]	ner. [greek akolouthos follower]	
Aconite	n. 1 any of various poisonous plants, esp. Monkshood. 2 drug from these. [greek akoniton]	od. 2 drug from these. [greek akoniton]	
Acorn	n. Fruit of the oak, with a smooth nut in a cuplike base. [old english]	e base. [old english]	
Acoustic	adj. 1 of sound or the sense of hearing. 2 (of a musical instrument etc.) Without electrical amplification (acoustic guitar).  acoustically adv. [greek akouo hear]	usical instrument etc.) Without electrical amplification (acoustic guitar).  acoustically adv. [greek akouo hear]	
Acoustics	n.pl. 1 properties or qualities (of a room etc.) In transmitting sound. 2 (usu. As sing.) Science of sound.	n transmitting sound. 2 (usu. As sing.) Science of sound.	
Acquaint	v. (usu. Foll. By with) make aware of or familiar with (acquaint me with the facts).  be acquainted with have personal knowledge of; know slightly. [latin: related to *ad-, *cognizance]	with (acquaint me with the facts).  be acquainted with have personal knowledge of; know slightly. [latin: related to *ad-, *cognizance]	
Acquaintance	n. 1 being acquainted. 2 person one knows slightly.  acquaintanceship n.	.  acquaintanceship n.	
Acquiesce	v. (-cing) 1 agree, esp. By default. 2 (foll. By in) accept (an arrangement etc.).  acquiescence n. Acquiescent adj. [latin: related to *ad-, *quiet]	n) accept (an arrangement etc.).  acquiescence n. Acquiescent adj. [latin: related to *ad-, *quiet]	
Acquire	v. (-ring) gain for oneself; come into possession of. [latin: related to *ad-, quaero quisit- seek]	of. [latin: related to *ad-, quaero quisit- seek]	
Acquired	immune deficiency syndrome  see *aids.		
Acquired	taste  n. 1 liking developed by experience. 2 object of this.	ct of this.	
Acquirement	n. Thing acquired, esp. A mental attainment.		
Acquisition	n. 1 thing acquired, esp. When useful. 2 acquiring or being acquired. [latin: related to *acquire]	 or being acquired. [latin: related to *acquire]	
Acquisitive	adj. Keen to acquire things.		
Acquit	v. (-tt-) 1 (often foll. By of) declare not guilty. 2 refl. A behave or perform in a specified way (acquitted herself well). B (foll. By of) discharge (a duty or responsibility).  acquittal n. [latin: related to *ad-, *quit]	. 2 refl. A behave or perform in a specified way (acquitted herself well). B (foll. By of) discharge (a duty or responsibility).  acquittal n. [latin: related to *ad-, *quit]	
Acre	n. Measure of land, 4,840 sq. Yds., 0.405 ha. [old english]	 english]	
Acreage	n. A number of acres; extent of land.		
Acrid	adj. (-er, -est) bitterly pungent.  acridity n. [latin acer keen, pungent]	latin acer keen, pungent]	
Acrimonious	adj. Bitter in manner or temper.  acrimony n.		
Acrobat	n. Entertainer performing gymnastic feats.  acrobatic adj. Acrobatically adv. [greek akrobates from akron summit, baino walk]	atic adj. Acrobatically adv. [greek akrobates from akron summit, baino walk]	
Acrobatics	n.pl. 1 acrobatic feats. 2 (as sing.) Art of performing these.	rming these.	
Acronym	n. Word formed from the initial letters of other words (e.g. Laser, nato). [greek akron end, onoma name]	ords (e.g. Laser, nato). [greek akron end, onoma name]	
Acropolis	n. Citadel of an ancient greek city. [greek akron summit, polis city]	summit, polis city]	
Across	â€”prep. 1 to or on the other side of (across the river). 2 from one side to another side of (spread across the floor). 3 at or forming an angle with (a stripe across the flag). â€”adv. 1 to or on the other side (ran across). 2 from one side to another (stretched across).  across the board applying to all. [french Ã , en, croix: related to *cross]	river). 2 from one side to another side of (spread across the floor). 3 at or forming an angle with (a stripe across the flag). â€”adv. 1 to or on the other side (ran across). 2 from one side to another (stretched across).  across the board applying to all. [french Ã , en, croix: related to *cross]	
Acrostic	n. Poem etc. In which certain letters (usu. The first and last in each line) form a word or words. [greek akron end, stikhos row]	rst and last in each line) form a word or words. [greek akron end, stikhos row]	
Acrylic	â€”adj. Of synthetic material made from acrylic acid. â€”n. Acrylic fibre or fabric. [latin acer pungent, oleo to smell]	id. â€”n. Acrylic fibre or fabric. [latin acer pungent, oleo to smell]	
Acrylic	acid  n. A pungent liquid organic acid.		
Act	â€”n. 1 something done; a deed. 2 process of doing (caught in the act). 3 item of entertainment. 4 pretence (all an act). 5 main division of a play etc. 6 a decree of a legislative body. B document attesting a legal transaction. â€”v. 1 behave (acted wisely). 2 perform an action or function; take action (act as referee; brakes failed to act; he acted quickly). 3 (also foll. By on) have an effect (alcohol acts on the brain). 4 a perform a part in a play, film, etc. B pretend. 5 a play the part of (acted othello; acts the fool). B perform (a play etc.). C portray (an incident) by actions.  act for be the (esp. Legal) representative of. Act of god natural event, e.g. An earthquake. Act up colloq. Misbehave; give trouble (car is acting up). Get one's act together slang become properly organized; prepare. Put on an act colloq. Make a pretence. [latin ago act- do]	 (caught in the act). 3 item of entertainment. 4 pretence (all an act). 5 main division of a play etc. 6 a decree of a legislative body. B document attesting a legal transaction. â€”v. 1 behave (acted wisely). 2 perform an action or function; take action (act as referee; brakes failed to act; he acted quickly). 3 (also foll. By on) have an effect (alcohol acts on the brain). 4 a perform a part in a play, film, etc. B pretend. 5 a play the part of (acted othello; acts the fool). B perform (a play etc.). C portray (an incident) by actions.  act for be the (esp. Legal) representative of. Act of god natural event, e.g. An earthquake. Act up colloq. Misbehave; give trouble (car is acting up). Get one's act together slang become properly organized; prepare. Put on an act colloq. Make a pretence. [latin ago act- do]	ed quickly). 3 (also foll. By on) have an effect (alcohol acts on the brain). 4 a perform a part in a play, film, etc. B pretend. 5 a play the part of (acted othello; acts the fool). B perform (a play etc.). C portray (an incident) by actions.  act for be the (esp. Legal) representative of. Act of god natural event, e.g. An earthquake. Act up colloq. Misbehave; give trouble (car is acting up). Get one's act together slang become properly organized; prepare. Put on an act colloq. Make a pretence. [latin ago act- do]
Acting	â€”n. Art or occupation of an actor. â€”attrib. Adj. Serving temporarily or as a substitute (acting manager).	j. Serving temporarily or as a substitute (acting manager).	
Actinism	n. Property of short-wave radiation that produces chemical changes, as in photography. [greek aktis ray]	chemical changes, as in photography. [greek aktis ray]	
Actinium	n. Chem. Radioactive metallic element found in pitchblende. [as *actinism]	chblende. [as *actinism]	
Action	n. 1 process of doing or acting (demanded action). 2 forcefulness or energy. 3 exertion of energy or influence (action of acid on metal). 4 deed, act (not aware of his actions). 5 (the action) a series of events in a story, play, etc. B slang exciting activity (missed the action). 6 battle, fighting (killed in action). 7 a mechanism of an instrument. B style of movement of an animal or human. 8 lawsuit.  out of action not working. [latin: related to *act]	 2 forcefulness or energy. 3 exertion of energy or influence (action of acid on metal). 4 deed, act (not aware of his actions). 5 (the action) a series of events in a story, play, etc. B slang exciting activity (missed the action). 6 battle, fighting (killed in action). 7 a mechanism of an instrument. B style of movement of an animal or human. 8 lawsuit.  out of action not working. [latin: related to *act]	t. B style of movement of an animal or human. 8 lawsuit.  out of action not working. [latin: related to *act]
Actionable	adj. Giving cause for legal action.		
Action-packed	adj. Full of action or excitement.		
Action	point  n. Proposal for action.		
Action	replay  n. Playback of part of a television broadcast, esp. A sporting event, often in slow motion.	ast, esp. A sporting event, often in slow motion.	
Action	stations  n.pl. Positions taken up by troops etc. Ready for battle.	Ready for battle.	
Activate	v. (-ting) 1 make active. 2 chem. Cause reaction in. 3 make radioactive.	n. 3 make radioactive.	
Active	â€”adj. 1 marked by action; energetic; diligent (an active life). 2 working, operative (active volcano). 3 not merely passive or inert; positive (active support; active ingredients). 4 radioactive. 5 gram. Designating the form of a verb whose subject performs the action (e.g. Saw in he saw a film). â€”n. Gram. Active form or voice of a verb.  actively adv. [latin: related to *act]	n active life). 2 working, operative (active volcano). 3 not merely passive or inert; positive (active support; active ingredients). 4 radioactive. 5 gram. Designating the form of a verb whose subject performs the action (e.g. Saw in he saw a film). â€”n. Gram. Active form or voice of a verb.  actively adv. [latin: related to *act]	vely adv. [latin: related to *act]
Active	service  n. Military service in wartime.		
Activism	n. Policy of vigorous action, esp. For a political cause.  activist n.	 cause.  activist n.	
Activity	n. (pl. -ies) 1 being active; busy or energetic action. 2 (often in pl.) Occupation or pursuit (outdoor activities). 3 = *radioactivity.	tion. 2 (often in pl.) Occupation or pursuit (outdoor activities). 3 = *radioactivity.	
Actor	n. Person who acts in a play, film, etc. [latin: related to *act]	elated to *act]	
Actress	n. Female actor.		
Actual	adj. (usu. Attrib.) 1 existing in fact; real. 2 current. [latin: related to *act]	rrent. [latin: related to *act]	
Actuality	n. (pl. -ies) 1 reality. 2 (in pl.) Existing conditions.	tions.	
Actually	adv. 1 as a fact, really (not actually very rich). 2 strange as it may seem (he actually refused!).	 2 strange as it may seem (he actually refused!).	
Actuary	n. (pl. -ies) statistician, esp. One calculating insurance risks and premiums.  actuarial adj. [latin actuarius bookkeeper]	nsurance risks and premiums.  actuarial adj. [latin actuarius bookkeeper]	
Actuate	v. (-ting) 1 cause (a machine etc.) To move or function. 2 cause (a person) to act. [latin]	ction. 2 cause (a person) to act. [latin]	
Acuity	n. Sharpness, acuteness. [medieval latin: related to *acute]	to *acute]	
Acumen	n. Keen insight or discernment. [latin, = *acute thing]	hing]	
Acupuncture	n. Medical treatment using needles in parts of the body.  acupuncturist n. [latin acu with needle]	 body.  acupuncturist n. [latin acu with needle]	
Acute	â€”adj. (acuter, acutest) 1 serious, severe (acute hardship). 2 (of senses etc.) Keen, penetrating. 3 shrewd. 4 (of a disease) coming quickly to a crisis. 5 (of an angle) less than 90Â°. 6 (of a sound) high, shrill. â€”n. = *acute accent.  acutely adv. [latin acutus pointed]	 hardship). 2 (of senses etc.) Keen, penetrating. 3 shrewd. 4 (of a disease) coming quickly to a crisis. 5 (of an angle) less than 90Â°. 6 (of a sound) high, shrill. â€”n. = *acute accent.  acutely adv. [latin acutus pointed]	
Acute	accent  n. Diacritical mark (Â´) placed over certain letters in french etc., esp. To show pronunciation.	in letters in french etc., esp. To show pronunciation.	
-acy	suffix forming nouns of state or quality (accuracy; piracy), or an instance of it (conspiracy; fallacy). [french -acie, latin -acia, -atia, greek -ateia]	; piracy), or an instance of it (conspiracy; fallacy). [french -acie, latin -acia, -atia, greek -ateia]	
Ad	abbr. Of the christian era. [*anno domini]		
Ad	n. Colloq. Advertisement. [abbreviation]		
Ad-	prefix (altered or assimilated before some letters) implying motion or direction to, reduction or change into, addition, adherence, increase, or intensification. [latin]	) implying motion or direction to, reduction or change into, addition, adherence, increase, or intensification. [latin]	
Adage	n. Traditional maxim, proverb. [french from latin]		
Adagio	mus. â€”adv. & adj. In slow time. â€”n. (pl. -s) such a movement or passage. [italian]	uch a movement or passage. [italian]	
Adam	n. The first man.  not know a person from adam be unable to recognize a person. [hebrew, = man]	 unable to recognize a person. [hebrew, = man]	
Adamant	adj. Stubbornly resolute; unyielding.  adamantly adv. [greek adamas adamant- untameable]	adv. [greek adamas adamant- untameable]	
Adam's	apple  n. Projection of cartilage at the front of the neck.	the neck.	
Adapt	v. 1 a (foll. By to) fit, adjust (one thing to another). B (foll. By to, for) make suitable for a purpose. C modify (esp. A text for broadcasting etc.). 2 (also refl., usu. Foll. By to) adjust to new conditions.  adaptable adj. Adaptation n. [latin: related to *ad-, *apt]	ther). B (foll. By to, for) make suitable for a purpose. C modify (esp. A text for broadcasting etc.). 2 (also refl., usu. Foll. By to) adjust to new conditions.  adaptable adj. Adaptation n. [latin: related to *ad-, *apt]	
Adaptor	n. 1 device for making equipment compatible. 2 device for connecting several electrical plugs to one socket.	ice for connecting several electrical plugs to one socket.	
Add	v. 1 join (one thing to another) as an increase or supplement. 2 put together (numbers) to find their total. 3 say further.  add in include. Add up 1 find the total of. 2 (foll. By to) amount to. 3 colloq. Make sense. [latin addo]	 supplement. 2 put together (numbers) to find their total. 3 say further.  add in include. Add up 1 find the total of. 2 (foll. By to) amount to. 3 colloq. Make sense. [latin addo]	
Addendum	n. (pl. -da) 1 thing to be added. 2 material added at the end of a book.	 at the end of a book.	
Adder	n. Small venomous snake, esp. The common viper. [old english, originally nadder]	ld english, originally nadder]	
Addict	n. 1 person addicted, esp. To a drug. 2 colloq. Devotee (film addict). [latin: related to *ad-, dico say]	votee (film addict). [latin: related to *ad-, dico say]	
Addicted	adj. 1 (usu. Foll. By to) dependent on a drug etc. As a habit. 2 devoted to an interest.  addiction n.	 As a habit. 2 devoted to an interest.  addiction n.	
Addictive	adj. Causing addiction.		
Addition	n. 1 adding. 2 person or thing added.  in addition (often foll. By to) also, as well (as). [latin: related to *add]	n (often foll. By to) also, as well (as). [latin: related to *add]	
Additional	adj. Added, extra, supplementary.  additionally adv.	dv.	
Additive	n. Substance added to improve another, esp. To colour, flavour, or preserve food. [latin: related to *add]	our, flavour, or preserve food. [latin: related to *add]	
Addle	v. (-ling) 1 muddle, confuse. 2 (usu. As addled adj.) (of an egg) become rotten. [old english, = filth]	j.) (of an egg) become rotten. [old english, = filth]	
Address	â€”n. 1 a place where a person lives or an organization is situated. B particulars of this, esp. For postal purposes. C computing location of an item of stored information. 2 discourse to an audience. â€”v. 1 write postal directions on (an envelope etc.). 2 direct (remarks etc.). 3 speak or write to, esp. Formally. 4 direct one's attention to. 5 golf take aim at (the ball).  address oneself to 1 speak or write to. 2 attend to. [french: related to *ad-, *direct]	ation is situated. B particulars of this, esp. For postal purposes. C computing location of an item of stored information. 2 discourse to an audience. â€”v. 1 write postal directions on (an envelope etc.). 2 direct (remarks etc.). 3 speak or write to, esp. Formally. 4 direct one's attention to. 5 golf take aim at (the ball).  address oneself to 1 speak or write to. 2 attend to. [french: related to *ad-, *direct]	lf take aim at (the ball).  address oneself to 1 speak or write to. 2 attend to. [french: related to *ad-, *direct]
Addressee	n. Person to whom a letter etc. Is addressed.		
Adduce	v. (-cing) cite as an instance or as proof or evidence.  adducible adj. [latin: related to *ad-, duco lead]	ence.  adducible adj. [latin: related to *ad-, duco lead]	
Adenoids	n.pl. Area of enlarged lymphatic tissue between the nose and the throat, often hindering breathing in the young.  adenoidal adj. [greek aden gland]	e nose and the throat, often hindering breathing in the young.  adenoidal adj. [greek aden gland]	
Adept	â€”adj. (foll. By at, in) skilful. â€”n. Adept person. [latin adipiscor adept- attain]	son. [latin adipiscor adept- attain]	
Adequate	adj. Sufficient, satisfactory.  adequacy n. Adequately adv. [latin: related to *ad-, *equate]	ately adv. [latin: related to *ad-, *equate]	
Ã€	deux  adv. & adj. For or between two. [french]		
Adhere	v. (-ring) 1 (usu. Foll. By to) stick fast to a substance etc. 2 (foll. By to) behave according to (a rule, undertaking, etc.). 3 (foll. By to) give allegiance. [latin haereo stick]	bstance etc. 2 (foll. By to) behave according to (a rule, undertaking, etc.). 3 (foll. By to) give allegiance. [latin haereo stick]	
Adherent	â€”n. Supporter. â€”adj. Sticking, adhering.  adherence n.	erence n.	
Adhesion	n. 1 adhering. 2 unnatural union of body tissues due to inflammation.	ue to inflammation.	
Adhesive	â€”adj. Sticky, causing adhesion. â€”n. Adhesive substance.  adhesiveness n.	ubstance.  adhesiveness n.	
Ad	hoc  adv. & adj. For one particular occasion or use. [latin]	e. [latin]	
Adieu	int. Goodbye. [french, = to god]		
Ad	infinitum  adv. Without limit; for ever. [latin]		
Adipose	adj. Of fat; fatty (adipose tissue).  adiposity n. [latin adeps fat]	. [latin adeps fat]	
Adjacent	adj. (often foll. By to) lying near; adjoining.  adjacency n. [latin jaceo lie]	adjacency n. [latin jaceo lie]	
Adjective	n. Word used to describe or modify a noun or pronoun.  adjectival adj. [latin jaceo lie]	un.  adjectival adj. [latin jaceo lie]	
Adjoin	v. Be next to and joined with. [latin jungo join]		
Adjourn	v. 1 put off, postpone; break off (a meeting etc.) Temporarily. 2 (of a meeting) break and disperse or (foll. By to) transfer to another place (adjourned to the pub).  adjournment n. [latin: related to *ad-, diurnum day]	 Temporarily. 2 (of a meeting) break and disperse or (foll. By to) transfer to another place (adjourned to the pub).  adjournment n. [latin: related to *ad-, diurnum day]	
Adjudge	v. (-ging) 1 pronounce judgement on (a matter). 2 pronounce or award judicially.  adjudgement n. (also adjudgment). [latin judex judge]	pronounce or award judicially.  adjudgement n. (also adjudgment). [latin judex judge]	
Adjudicate	v. (-ting) 1 act as judge in a competition, court, etc. 2 adjudge.  adjudication n. Adjudicative adj. Adjudicator n.	 etc. 2 adjudge.  adjudication n. Adjudicative adj. Adjudicator n.	
Adjunct	n. 1 (foll. By to, of) subordinate or incidental thing. 2 gram. Word or phrase used to explain or amplify the predicate, subject, etc. [latin: related to *adjoin]	hing. 2 gram. Word or phrase used to explain or amplify the predicate, subject, etc. [latin: related to *adjoin]	
Adjure	v. (-ring) (usu. Foll. By to + infin.) Beg or command.  adjuration n. [latin adjuro put to oath: related to *jury]	and.  adjuration n. [latin adjuro put to oath: related to *jury]	
Adjust	v. 1 order or position; regulate; arrange. 2 (usu. Foll. By to) become or make suited; adapt. 3 harmonize (discrepancies). 4 assess (loss or damages).  adjustable adj. Adjustment n. [latin juxta near]	 Foll. By to) become or make suited; adapt. 3 harmonize (discrepancies). 4 assess (loss or damages).  adjustable adj. Adjustment n. [latin juxta near]	
Adjutant	n. 1 a army officer assisting a superior in administrative duties. B assistant. 2 (in full adjutant bird) giant indian stork. [latin: related to *ad-, juvo jut- help]	strative duties. B assistant. 2 (in full adjutant bird) giant indian stork. [latin: related to *ad-, juvo jut- help]	
Ad	lib  â€”v. (-bb-) improvise. â€”adj. Improvised. â€”adv. As one pleases, to any desired extent. [abbreviation of latin ad libitum according to pleasure]	€”adv. As one pleases, to any desired extent. [abbreviation of latin ad libitum according to pleasure]	
Admin	n. Colloq. Administration. [abbreviation]		
Administer	v. 1 manage (business affairs etc.). 2 a deliver or dispense, esp. Formally (a punishment, sacrament, etc.). B (usu. Foll. By to) direct the taking of (an oath). [latin: related to *ad-, *minister]	r dispense, esp. Formally (a punishment, sacrament, etc.). B (usu. Foll. By to) direct the taking of (an oath). [latin: related to *ad-, *minister]	
Administrate	v. (-ting) administer (esp. Business affairs); act as an administrator.	 as an administrator.	
Administration	n. 1 administering, esp. Public affairs. 2 government in power.	ent in power.	
Administrative	adj. Of the management of affairs.		
Administrator	n. Manager of a business, public affairs, or a person's estate.	son's estate.	
Admirable	adj. Deserving admiration; excellent.  admirably adv. [latin: related to *admire]	adv. [latin: related to *admire]	
Admiral	n. 1 a commander-in-chief of a navy. B high-ranking naval officer, commander. 2 any of various butterflies. [arabic: related to *amir]	g naval officer, commander. 2 any of various butterflies. [arabic: related to *amir]	
Admiralty	n. (pl. -ies) (in full admiralty board) hist. Committee superintending the royal navy.	ittee superintending the royal navy.	
Admiration	n. 1 respect; warm approval or pleasure. 2 object of this.	of this.	
Admire	v. (-ring) 1 regard with approval, respect, or satisfaction. 2 express admiration of.  admirer n. Admiring adj. Admirlingly adv. [latin: related to *ad-, miror wonder at]	isfaction. 2 express admiration of.  admirer n. Admiring adj. Admirlingly adv. [latin: related to *ad-, miror wonder at]	
Admissible	adj. 1 (of an idea etc.) Worth accepting or considering. 2 law allowable as evidence. [latin: related to *admit]	ering. 2 law allowable as evidence. [latin: related to *admit]	
Admission	n. 1 acknowledgement (admission of error). 2 a process or right of entering. B charge for this (admission is Â£5).	cess or right of entering. B charge for this (admission is Â£5).	
Admit	v. (-tt-) 1 (often foll. By to be, or that + clause) acknowledge; recognize as true. 2 (foll. By to) confess to (a deed, fault, etc.). 3 allow (a person) entrance, access, etc. 4 take (a patient) into hospital. 5 (of an enclosed space) accommodate. 6 (foll. By of) allow as possible. [latin mitto miss- send]	e) acknowledge; recognize as true. 2 (foll. By to) confess to (a deed, fault, etc.). 3 allow (a person) entrance, access, etc. 4 take (a patient) into hospital. 5 (of an enclosed space) accommodate. 6 (foll. By of) allow as possible. [latin mitto miss- send]	
Admittance	n. Admitting or being admitted, usu. To a place.		
Admittedly	adv. As must be admitted.		
Admixture	n. 1 thing added, esp. A minor ingredient. 2 adding of this.	g of this.	
Admonish	v. 1 reprove. 2 urge, advise. 3 (foll. By of) warn.  admonishment n. Admonition n. Admonitory adj. [latin moneo warn]	.  admonishment n. Admonition n. Admonitory adj. [latin moneo warn]	
Ad	nauseam  adv. Excessively; disgustingly. [latin, = to sickness]	 to sickness]	
Ado	n. Fuss, busy activity; trouble. [from *at, *do1: originally in much ado = much to do]	originally in much ado = much to do]	
Adobe	n. 1 sun-dried brick. 2 clay for making these. [spanish]	anish]	
Adolescent	â€”adj. Between childhood and adulthood. â€”n. Adolescent person.  adolescence n. [latin adolesco grow up]	lescent person.  adolescence n. [latin adolesco grow up]	
Adonis	n. Handsome young man. [latin, name of a youth loved by venus]	ed by venus]	
Adopt	v. 1 legally take (a person) into a relationship, esp. Another's child as one's own. 2 choose (a course of action etc.). 3 take over (another's idea etc.). 4 choose as a candidate for office. 5 accept responsibility for the maintenance of (a road etc.). 6 accept or approve (a report, accounts, etc.).  adoption n. [latin: related to *ad-, *opt]	esp. Another's child as one's own. 2 choose (a course of action etc.). 3 take over (another's idea etc.). 4 choose as a candidate for office. 5 accept responsibility for the maintenance of (a road etc.). 6 accept or approve (a report, accounts, etc.).  adoption n. [latin: related to *ad-, *opt]	
Adoptive	adj. Because of adoption (adoptive son). [latin: related to *adopt]	elated to *adopt]	
Adorable	adj. 1 deserving adoration. 2 colloq. Delightful, charming.	charming.	
Adore	v. (-ring) 1 love intensely. 2 worship as divine. 3 colloq. Like very much.  adoration n. Adorer n. [latin adoro worship]	3 colloq. Like very much.  adoration n. Adorer n. [latin adoro worship]	
Adorn	v. Add beauty to; decorate.  adornment n. [latin: related to *ad-, orno decorate]	 related to *ad-, orno decorate]	
Adrenal	â€”adj. 1 at or near the kidneys. 2 of the adrenal glands. â€”n. (in full adrenal gland) either of two ductless glands above the kidneys, secreting adrenalin. [from *ad-, *renal]	 glands. â€”n. (in full adrenal gland) either of two ductless glands above the kidneys, secreting adrenalin. [from *ad-, *renal]	
Adrenalin	n. (also adrenaline) 1 stimulative hormone secreted by the adrenal glands. 2 this extracted or synthesized for medicinal use.	d by the adrenal glands. 2 this extracted or synthesized for medicinal use.	
Adrift	adv. & predic.adj. 1 drifting. 2 powerless; aimless. 3 colloq. A unfastened. B out of order, wrong (plans went adrift).	s. 3 colloq. A unfastened. B out of order, wrong (plans went adrift).	
Adroit	adj. Dexterous, skilful. [french Ã  droit according to right]	g to right]	
Adsorb	v. (usu. Of a solid) hold (molecules of a gas or liquid etc.) To its surface, forming a thin film.  adsorbent adj. & n. Adsorption n. [from *ad-, *absorb]	iquid etc.) To its surface, forming a thin film.  adsorbent adj. & n. Adsorption n. [from *ad-, *absorb]	
Adulation	n. Obsequious flattery. [latin adulor fawn on]		
Adult	â€”adj. 1 mature, grown-up. 2 (attrib.) Of or for adults (adult education). â€”n. Adult person.  adulthood n. [latin adolesco adultus grow up]	adults (adult education). â€”n. Adult person.  adulthood n. [latin adolesco adultus grow up]	
Adulterate	v. (-ting) debase (esp. Foods) by adding other substances.  adulterant adj. & n. Adulteration n. [latin adultero corrupt]	stances.  adulterant adj. & n. Adulteration n. [latin adultero corrupt]	
Adulterer	n. (fem. Adulteress) person who commits adultery.		
Adultery	n. Voluntary sexual intercourse between a married person and a person other than his or her spouse.  adulterous adj.	person and a person other than his or her spouse.  adulterous adj.	
Adumbrate	v. (-ting) 1 indicate faintly or in outline. 2 foreshadow. 3 overshadow.  adumbration n. [latin: related to *ad-, umbra shade]	eshadow. 3 overshadow.  adumbration n. [latin: related to *ad-, umbra shade]	
Advance	â€”v. (-cing) 1 move or put forward; progress. 2 pay or lend (money) beforehand. 3 promote (a person, cause, etc.). 4 present (a suggestion etc.). 5 (as advanced adj.) A well ahead. B socially progressive. â€”n. 1 going forward; progress. 2 prepayment; loan. 3 (in pl.) Amorous approaches. 4 rise in price. â€”attrib. Adj. Done or supplied beforehand (advance warning).  advance on approach threateningly. In advance ahead in place or time. [latin: related to *ab-, ante before]	ay or lend (money) beforehand. 3 promote (a person, cause, etc.). 4 present (a suggestion etc.). 5 (as advanced adj.) A well ahead. B socially progressive. â€”n. 1 going forward; progress. 2 prepayment; loan. 3 (in pl.) Amorous approaches. 4 rise in price. â€”attrib. Adj. Done or supplied beforehand (advance warning).  advance on approach threateningly. In advance ahead in place or time. [latin: related to *ab-, ante before]	 (advance warning).  advance on approach threateningly. In advance ahead in place or time. [latin: related to *ab-, ante before]
Advanced	level  n. High level of gce examination.		
Advancement	n. Promotion of a person, cause, or plan.		
Advantage	â€”n. 1 beneficial feature. 2 benefit, profit. 3 (often foll. By over) superiority. 4 (in tennis) the next point after deuce. â€”v. (-ging) benefit, favour.  take advantage of 1 make good use of. 2 exploit, esp. Unfairly. 3 euphem. Seduce.  advantageous adj. [french: related to *advance]	often foll. By over) superiority. 4 (in tennis) the next point after deuce. â€”v. (-ging) benefit, favour.  take advantage of 1 make good use of. 2 exploit, esp. Unfairly. 3 euphem. Seduce.  advantageous adj. [french: related to *advance]	
Advent	n. 1 season before christmas. 2 coming of christ. 3 (advent) important arrival. [latin adventus from venio come]	3 (advent) important arrival. [latin adventus from venio come]	
Adventist	n. Member of a christian sect believing in the imminent second coming of christ.	inent second coming of christ.	
Adventitious	adj. 1 accidental, casual. 2 added from outside. 3 biol. Formed accidentally or under unusual conditions. [latin: related to *advent]	 biol. Formed accidentally or under unusual conditions. [latin: related to *advent]	
Adventure	â€”n. 1 unusual and exciting experience. 2 enterprise (spirit of adventure). â€”v. (-ring) dare, venture; engage in adventure. [latin: related to *advent]	ise (spirit of adventure). â€”v. (-ring) dare, venture; engage in adventure. [latin: related to *advent]	
Adventure	playground  n. Playground with climbing-frames, building blocks, etc.	ilding blocks, etc.	
Adventurer	n. (fem. Adventuress) 1 person who seeks adventure, esp. For personal gain or enjoyment. 2 financial speculator.	, esp. For personal gain or enjoyment. 2 financial speculator.	
Adventurous	adj. Venturesome, enterprising.		
Adverb	n. Word indicating manner, degree, circumstance, etc., used to modify an adjective, verb, or other adverb (e.g. Gently, quite, then).  adverbial adj. [latin: related to *ad-, verbum word, *verb]	tc., used to modify an adjective, verb, or other adverb (e.g. Gently, quite, then).  adverbial adj. [latin: related to *ad-, verbum word, *verb]	
Adversary	n. (pl. -ies) enemy, opponent.		
Adverse	adj. Unfavourable; harmful.  adversely adv. [latin: related to *ad-, verto vers- turn]	n: related to *ad-, verto vers- turn]	
Adversity	n. Misfortune, distress.		
Advert	n. Colloq. Advertisement. [abbreviation]		
Advertise	v. (-sing) 1 promote (goods or services) publicly to increase sales. 2 make generally known. 3 (often foll. By for) seek by a notice in a newspaper etc. To buy, employ, sell, etc. [french avertir: related to *adverse]	to increase sales. 2 make generally known. 3 (often foll. By for) seek by a notice in a newspaper etc. To buy, employ, sell, etc. [french avertir: related to *adverse]	
Advertisement	n. 1 public announcement, esp. Of goods etc. For sale or wanted, vacancies, etc. 2 advertising. [french avertissement: related to *adverse]	ale or wanted, vacancies, etc. 2 advertising. [french avertissement: related to *adverse]	
Advice	n. 1 recommendation on how to act. 2 information given; news. 3 formal notice of a transaction.	iven; news. 3 formal notice of a transaction.	
Advisable	adj. To be recommended, expedient.  advisability n.	n.	
Advise	v. (-sing) 1 (also absol.) Give advice to. 2 recommend (advised me to rest). 3 (usu. Foll. By of, or that + clause) inform. [latin: related to *ad-, video vis- see]	mend (advised me to rest). 3 (usu. Foll. By of, or that + clause) inform. [latin: related to *ad-, video vis- see]	
Advisedly	adv. After due consideration; deliberately.		
Adviser	n. (also advisor) person who advises, esp. Officially.	lly.	
Usage	the variant advisor is fairly common, but is considered incorrect by many people.	dered incorrect by many people.	
Advisory	adj. Giving advice (advisory body).		
Advocaat	n. Liqueur of eggs, sugar, and brandy. [dutch, = *advocate]	advocate]	
Advocacy	n. Support or argument for a cause, policy, etc.		
Advocate	â€”n. 1 (foll. By of) person who supports or speaks in favour. 2 person who pleads for another, esp. In a lawcourt. â€”v. (-ting) recommend by argument. [latin: related to *ad-, voco call]	s in favour. 2 person who pleads for another, esp. In a lawcourt. â€”v. (-ting) recommend by argument. [latin: related to *ad-, voco call]	
Adz	n. (brit adze) tool like an axe, with an arched blade at right angles to the handle. [old english]	ade at right angles to the handle. [old english]	
Adze	n. (us adz) tool like an axe, with an arched blade at right angles to the handle. [old english]	 at right angles to the handle. [old english]	
Aegis	n. Protection; support. [greek aigis shield of zeus or athene]	s or athene]	
Aeolian	harp  n. Stringed instrument or toy sounding when the wind passes through it. [latin aeolus wind-god, from greek]	the wind passes through it. [latin aeolus wind-god, from greek]	
Aeon	n. (also eon) 1 long or indefinite period. 2 an age. [latin from greek]	e. [latin from greek]	
Aerate	v. (-ting) 1 charge (a liquid) with carbon dioxide. 2 expose to air.  aeration n. [latin aer *air]	. 2 expose to air.  aeration n. [latin aer *air]	
Aerial	â€”n. Device for transmitting or receiving radio waves. â€”adj. 1 by or from the air; involving aircraft (aerial attack). 2 existing in the air. 3 of or like air. [greek: related to *air]	aves. â€”adj. 1 by or from the air; involving aircraft (aerial attack). 2 existing in the air. 3 of or like air. [greek: related to *air]	
Aero-	comb. Form air; aircraft. [greek aero- from aer air]	r]	
Aerobatics	n.pl. 1 spectacular flying of aircraft, esp. To entertain. 2 (as sing.) Performance of these. [from *aero-, after *acrobatics]	tertain. 2 (as sing.) Performance of these. [from *aero-, after *acrobatics]	
Aerobics	n.pl. Vigorous exercises designed to increase oxygen intake.  aerobic adj. [from *aero-, greek bios life]	en intake.  aerobic adj. [from *aero-, greek bios life]	
Aerodrome	n. Small airport or airfield. [from *aero-, greek dromos course]	dromos course]	
Aerodynamics	n.pl. (usu. Treated as sing.) Dynamics of solid bodies moving through air.  aerodynamic adj.	dies moving through air.  aerodynamic adj.	
Aerofoil	n. Structure with curved surfaces (e.g. A wing, fin, or tailplane) designed to give lift in flight.	n, or tailplane) designed to give lift in flight.	
Aeronautics	n.pl. (usu. Treated as sing.) Science or practice of motion in the air.  aeronautic adj. Aeronautical adj. [from *aero-, *nautical]	of motion in the air.  aeronautic adj. Aeronautical adj. [from *aero-, *nautical]	
Aeroplane	n. Powered heavier-than-air flying vehicle with fixed wings. [french: related to *aero-, *plane1]	xed wings. [french: related to *aero-, *plane1]	
Aerosol	n. 1 pressurized container releasing a substance as a fine spray. 2 system of minute particles suspended in gas (e.g. Fog or smoke). [from *aero-, *solution]	s a fine spray. 2 system of minute particles suspended in gas (e.g. Fog or smoke). [from *aero-, *solution]	
Aerospace	n. 1 earth's atmosphere and outer space. 2 aviation in this.	n in this.	
Aesthete	n. Person who has or professes a special appreciation of beauty. [greek aisthanomai perceive]	ion of beauty. [greek aisthanomai perceive]	
Aesthete	n. Person who has or professes a special appreciation of beauty. [greek aisthanomai perceive]	ion of beauty. [greek aisthanomai perceive]	
Aesthetic	â€”adj. 1 of or sensitive to beauty. 2 artistic, tasteful. â€”n. (in pl.) Philosophy of beauty, esp. In art.  aesthetically adv. Aestheticism n.	asteful. â€”n. (in pl.) Philosophy of beauty, esp. In art.  aesthetically adv. Aestheticism n.	
Aetiology	n. (us etiology) study of causation or of the causes of disease.  aetiological adj. [greek aitia cause]	es of disease.  aetiological adj. [greek aitia cause]	
Af	abbr. Audio frequency.		
Afar	adv. At or to a distance.		
Affable	adj. 1 friendly. 2 courteous.  affability n. Affably adv. [latin affabilis]	bly adv. [latin affabilis]	
Affair	n. 1 matter, concern, or thing to be attended to (that is my affair). 2 a celebrated or notorious happening. B colloq. Thing or event (puzzling affair). 3 = *love affair. 4 (in pl.) Public or private business. [french Ã  faire to do]	that is my affair). 2 a celebrated or notorious happening. B colloq. Thing or event (puzzling affair). 3 = *love affair. 4 (in pl.) Public or private business. [french Ã  faire to do]	
Affect	v. 1 a produce an effect on. B (of disease etc.) Attack. 2 move emotionally. 3 pretend (affected ignorance). 4 pose as or use for effect (affects the aesthete; affects fancy hats).  affecting adj. Affectingly adv. [latin afficio affect- influence]	ttack. 2 move emotionally. 3 pretend (affected ignorance). 4 pose as or use for effect (affects the aesthete; affects fancy hats).  affecting adj. Affectingly adv. [latin afficio affect- influence]	
Usage	affect should not be confused with effect, meaning â€˜to bring aboutâ€™. Note also that effect is used as a noun as well as a verb.	 â€˜to bring aboutâ€™. Note also that effect is used as a noun as well as a verb.	
Affectation	n. 1 artificial manner. 2 (foll. By of) studied display. 3 pretence.	splay. 3 pretence.	
Affected	adj. 1 pretended, artificial. 2 full of affectation.	n.	
Affection	n. 1 goodwill, fond feeling. 2 disease; diseased condition.	ondition.	
Affectionate	adj. Loving, fond.  affectionately adv.		
Affidavit	n. Written statement confirmed by oath. [latin, = has stated on oath]	has stated on oath]	
Affiliate	â€”v. (-ting) (foll. By to, with) attach, adopt, or connect as a member or branch. â€”n. Affiliated person etc. [latin: related to *filial]	r connect as a member or branch. â€”n. Affiliated person etc. [latin: related to *filial]	
Affiliation	n. Affiliating or being affiliated.		
Affiliation	order  n. Legal order against the supposed father of an illegitimate child for support.	of an illegitimate child for support.	
Affinity	n. (pl. -ies) 1 liking or attraction; feeling of kinship. 2 relationship, esp. By marriage. 3 similarity of structure or character suggesting a relationship. 4 chem. The tendency of certain substances to combine with others. [latin finis border] 	inship. 2 relationship, esp. By marriage. 3 similarity of structure or character suggesting a relationship. 4 chem. The tendency of certain substances to combine with others. [latin finis border] 	
Affirm	v. 1 assert, state as a fact. 2 law make a solemn declaration in place of an oath.  affirmation n. [latin: related to *firm1]	declaration in place of an oath.  affirmation n. [latin: related to *firm1]	
Affirmative	â€”adj. Affirming; expressing approval. â€”n. Affirmative statement or word etc.	rmative statement or word etc.	
Affix	â€”v. 1 attach, fasten. 2 add in writing. â€”n. 1 addition. 2 gram. Prefix or suffix. [latin: related to *fix]	addition. 2 gram. Prefix or suffix. [latin: related to *fix]	
Afflict	v. Distress physically or mentally. [latin fligo flict- strike down]	lict- strike down]	
Affliction	n. 1 distress, suffering. 2 cause of this.		
Affluent	adj. Wealthy, rich.  affluence n. [latin: related to *fluent]	 to *fluent]	
Afford	v. 1 (prec. By can or be able to) a have enough money, time, etc., for; be able to spare. B be in a position (can't afford to be critical). 2 provide (affords a view of the sea). [old english ge- prefix implying completeness, *forth]	ney, time, etc., for; be able to spare. B be in a position (can't afford to be critical). 2 provide (affords a view of the sea). [old english ge- prefix implying completeness, *forth]	
Afforest	v. 1 convert into forest. 2 plant with trees.  afforestation n. [latin: related to *forest]	forestation n. [latin: related to *forest]	
Affray	n. Breach of the peace by fighting or rioting in public. [anglo-french = â€˜remove from peaceâ€™]	ublic. [anglo-french = â€˜remove from peaceâ€™]	
Affront	â€”n. Open insult. â€”v. Insult openly; offend, embarrass. [latin: related to *front]	barrass. [latin: related to *front]	
Afghan	â€”n. 1 a native or national of afghanistan. B person of afghan descent. 2 official language of afghanistan. â€”adj. Of afghanistan. [pashto]	son of afghan descent. 2 official language of afghanistan. â€”adj. Of afghanistan. [pashto]	
Afghan	hound  n. Tall hunting dog with long silky hair.		
Aficionado	n. (pl. -s) devotee of a sport or pastime. [spanish]	h]	
Afield	adv. To or at a distance (esp. Far afield). [old english: related to *a2]	nglish: related to *a2]	
Aflame	adv. & predic.adj. 1 in flames. 2 very excited.		
Afloat	adv. & predic.adj. 1 floating. 2 at sea. 3 out of debt or difficulty. 4 current. [old english: related to *a2]	debt or difficulty. 4 current. [old english: related to *a2]	
Afoot	adv. & predic.adj. In operation; progressing.		
Afore	prep. & adv. Archaic before; previously; in front (of). [old english: related to *a2]	(of). [old english: related to *a2]	
Afore-	comb. Form before, previously (aforementioned; aforesaid).	resaid).	
Afore	prep. & adv. Archaic before; previously; in front (of). [old english: related to *a2]	(of). [old english: related to *a2]	
Afore-	comb. Form before, previously (aforementioned; aforesaid).	resaid).	
Aforethought	adj. Premeditated (following a noun: malice aforethought).	hought).	
Afraid	predic. Adj. Alarmed, frightened.  be afraid colloq. Politely regret (i'm afraid we're late). [originally past part. Of *affray]	oq. Politely regret (i'm afraid we're late). [originally past part. Of *affray]	
Afresh	adv. Anew; with a fresh beginning. [earlier of fresh]	sh]	
African	â€”n. 1 native (esp. Dark-skinned) of africa. 2 person of african descent. â€”adj. Of africa. [latin]	rson of african descent. â€”adj. Of africa. [latin]	
African	elephant  n. The elephant of africa, larger than that of india.	hat of india.	
African	violet  n. House-plant with velvety leaves and blue, purple, or pink flowers.	e, purple, or pink flowers.	
Afrikaans	n. Language derived from dutch, used in s. Africa. [dutch, = â€˜africanâ€™]	 [dutch, = â€˜africanâ€™]	
Afrikaner	n. Afrikaans-speaking white person in s. Africa, esp. Of dutch descent.	sp. Of dutch descent.	
Afro	â€”adj. (of hair) tightly-curled and bushy. â€”n. (pl. -s) afro hairstyle.	(pl. -s) afro hairstyle.	
Afro-	comb. Form african.		
Afro-american	â€”adj. Of american blacks or their culture. â€”n. American black.	 American black.	
Afro-caribbean	â€”n. Caribbean person of african descent. â€”adj. Of afro-caribbeans.	 Of afro-caribbeans.	
Aft	adv. Naut. & aeron. At or towards the stern or tail. [earlier baft]	l. [earlier baft]	
After	â€”prep. 1 following in time; later than (after a week). 2 in view of, in spite of (after what you did what do you expect?; after all my efforts i still lost). 3 behind (shut the door after you). 4 in pursuit or quest of (run after them). 5 about, concerning (asked after her). 6 in allusion to (named after the prince). 7 in imitation of (a painting after rubens). 8 next in importance to (best one after mine). â€”conj. Later than (left after they arrived). â€”adv. 1 later (soon after). 2 behind (followed on after). â€”adj. 1 later, following (in after years). 2 naut. Nearer the stern (after cabins).  after all in spite of everything (after all, what does it matter?). After one's own heart to one's taste. [old english]	week). 2 in view of, in spite of (after what you did what do you expect?; after all my efforts i still lost). 3 behind (shut the door after you). 4 in pursuit or quest of (run after them). 5 about, concerning (asked after her). 6 in allusion to (named after the prince). 7 in imitation of (a painting after rubens). 8 next in importance to (best one after mine). â€”conj. Later than (left after they arrived). â€”adv. 1 later (soon after). 2 behind (followed on after). â€”adj. 1 later, following (in after years). 2 naut. Nearer the stern (after cabins).  after all in spite of everything (after all, what does it matter?). After one's own heart to one's taste. [old english]	 after rubens). 8 next in importance to (best one after mine). â€”conj. Later than (left after they arrived). â€”adv. 1 later (soon after). 2 behind (followed on after). â€”adj. 1 later, following (in after years). 2 naut. Nearer the stern (after cabins).  after all in spite of everything (after all, what does it matter?). After one's own heart to one's taste. [old english]
Afterbirth	n. Placenta etc. Discharged from the womb after childbirth.	ildbirth.	
After-care	n. Attention after leaving hospital etc.		
After-effect	n. Delayed effect following an accident, trauma, etc.	tc.	
Afterglow	n. Glow remaining after its source has disappeared.	.	
Afterlife	n. Life after death.		
Aftermath	n. 1 consequences, esp. Unpleasant (aftermath of war). 2 new grass growing after mowing. [from *after, math mowing]	ar). 2 new grass growing after mowing. [from *after, math mowing]	
Afternoon	n. Time from noon or lunch-time to evening.		
Afterpains	n.pl. Pains caused by contraction of the womb after childbirth.	r childbirth.	
Afters	n.pl. Colloq. = *dessert 1.		
Aftershave	n. Lotion used after shaving.		
Aftertaste	n. Taste after eating or drinking.		
Afterthought	n. Thing thought of or added later.		<Å
Afterward	adv. (brit. Afterwards) later, subsequently. [old english: related to *after, *-ward]	english: related to *after, *-ward]	
Afterwards	adv. (us afterward) later, subsequently. [old english: related to *after, *-ward]	ish: related to *after, *-ward]	ion
Ag	symb. Silver. [latin argentum]		py
Again	adv. 1 another time; once more. 2 as previously (home again; well again). 3 in addition (as much again). 4 further, besides (again, what about you?). 5 on the other hand (i might, and again i might not).  again and again repeatedly. [old english]	ome again; well again). 3 in addition (as much again). 4 further, besides (again, what about you?). 5 on the other hand (i might, and again i might not).  again and again repeatedly. [old english]	
Against	prep. 1 in opposition to (fight against crime). 2 into collision or in contact with (lean against the wall). 3 to the disadvantage of (my age is against me). 4 in contrast to (against a dark background). 5 in anticipation of (against his coming; against the